Date,Exchange,FX,Return,r,3m,3mvUS,OI,NCL,NCS,NCSP,CL,CS,TRL,TRS,NRL,NRS,Contract
30/12/2008,CAD,1.2199,-0.04%,-0.0004,1.55,-0.01,47479,8473,18828,1028,16147,11281,25648,31137,21831,16342,"(CONTRACTS OF CAD 100,000)"
22/12/2008,CAD,1.2194,-1.23%,-0.0122,1.57,-0.17,43701,9345,19375,779,13793,8485,23917,28639,19784,15062,"(CONTRACTS OF CAD 100,000)"
16/12/2008,CAD,1.2046,4.79%,0.0491,1.65,-0.17,85413,10729,17477,3051,47649,46427,61429,66955,23984,18458,"(CONTRACTS OF CAD 100,000)"
09/12/2008,CAD,1.2652,-1.04%,-0.0103,2,-0.05,86795,12579,21408,1654,48345,43410,62578,66472,24217,20323,"(CONTRACTS OF CAD 100,000)"
02/12/2008,CAD,1.2522,-2.21%,-0.0219,2.05,-1.28,88581,13076,22783,3039,51053,45416,67168,71238,21413,17343,"(CONTRACTS OF CAD 100,000)"
25/11/2008,CAD,1.2251,0.22%,0.0022,2.45,-0.99,83766,12521,18790,3351,44510,44179,60382,66320,23384,17446,"(CONTRACTS OF CAD 100,000)"
18/11/2008,CAD,1.2278,-1.89%,-0.0187,3.04,0.77,92554,15426,22603,2976,48759,47530,67161,73109,25393,19445,"(CONTRACTS OF CAD 100,000)"
11/11/2008,CAD,1.205,-4.75%,-0.0464,2.97,0.55,98146,16067,19312,3559,54695,56699,74321,79570,23825,18576,"(CONTRACTS OF CAD 100,000)"
04/11/2008,CAD,1.1504,9.52%,0.1001,3.04,0.72,107787,17145,24639,3820,57222,55389,78187,83848,29600,23939,"(CONTRACTS OF CAD 100,000)"
28/10/2008,CAD,1.2715,-4.77%,-0.0466,3.14,-0.43,107866,18065,27912,4054,59656,56179,81775,88145,26091,19721,"(CONTRACTS OF CAD 100,000)"
21/10/2008,CAD,1.2136,-4.49%,-0.0439,3.48,-0.02,111438,20698,33093,3162,64022,53851,87882,90106,23556,21332,"(CONTRACTS OF CAD 100,000)"
14/10/2008,CAD,1.1615,-5.22%,-0.0509,4.14,-0.34,98295,16220,34104,3200,56665,42642,76085,79946,22210,18349,"(CONTRACTS OF CAD 100,000)"
07/10/2008,CAD,1.1039,-3.73%,-0.0366,4.11,-0.59,94501,18431,35583,3941,51447,33907,73819,73431,20682,21070,"(CONTRACTS OF CAD 100,000)"
30/09/2008,CAD,1.0642,-2.60%,-0.0257,4.26,-0.07,93626,19691,37712,5921,47684,30293,73296,73926,20330,19700,"(CONTRACTS OF CAD 100,000)"
23/09/2008,CAD,1.0372,3.14%,0.0319,3.88,-0.2,92330,17090,35743,4726,47346,30429,69162,70898,23168,21432,"(CONTRACTS OF CAD 100,000)"
16/09/2008,CAD,1.0708,0.06%,0.0006,3.25,0.53,145036,33090,43312,5280,80684,70204,119054,118796,25982,26240,"(CONTRACTS OF CAD 100,000)"
09/09/2008,CAD,1.0714,-0.40%,-0.004,3.33,0.48,142344,36134,46118,7945,74147,62721,118226,116784,24118,25560,"(CONTRACTS OF CAD 100,000)"
02/09/2008,CAD,1.0671,-1.82%,-0.0181,3.2,0.34,122277,37205,54779,5813,54447,34106,97465,94698,24812,27579,"(CONTRACTS OF CAD 100,000)"
26/08/2008,CAD,1.048,1.17%,0.0118,3.2,0.45,116253,33329,49093,4366,50528,35142,88223,88601,28030,27652,"(CONTRACTS OF CAD 100,000)"
19/08/2008,CAD,1.0604,0.39%,0.0039,3.16,0.25,126865,38641,66726,4538,58423,27097,101602,98361,25263,28504,"(CONTRACTS OF CAD 100,000)"
12/08/2008,CAD,1.0645,-2.13%,-0.0211,3.08,0.23,121154,33650,58979,5604,55920,29761,95174,94344,25980,26810,"(CONTRACTS OF CAD 100,000)"
05/08/2008,CAD,1.0423,-1.82%,-0.018,3.19,0.36,116660,35442,54214,4270,50256,32458,89968,90942,26692,25718,"(CONTRACTS OF CAD 100,000)"
29/07/2008,CAD,1.0237,-1.59%,-0.0158,3.2,0.49,97065,29682,31928,3570,35531,40381,68783,75879,28282,21186,"(CONTRACTS OF CAD 100,000)"
22/07/2008,CAD,1.0077,-0.67%,-0.0067,3.19,0.31,99845,43572,21683,3280,22765,53058,69617,78021,30228,21824,"(CONTRACTS OF CAD 100,000)"
15/07/2008,CAD,1.001,1.75%,0.0176,3.2,0.33,97365,39972,27113,2162,25494,48159,67628,77434,29737,19931,"(CONTRACTS OF CAD 100,000)"
08/07/2008,CAD,1.0188,0.33%,0.0033,3.24,0.24,91389,30183,36135,2426,30157,29263,62766,67824,28623,23565,"(CONTRACTS OF CAD 100,000)"
01/07/2008,CAD,1.0222,-1.03%,-0.0102,3.29,0.47,87207,24732,34522,2216,29255,26447,56203,63185,31004,24022,"(CONTRACTS OF CAD 100,000)"
24/06/2008,CAD,1.0118,0.69%,0.0069,3.24,0.39,84325,27397,31886,2218,23960,21945,53575,56049,30750,28276,"(CONTRACTS OF CAD 100,000)"
17/06/2008,CAD,1.0188,0.29%,0.0029,3.45,0.56,130634,36386,37337,2288,50605,51433,89279,91058,41355,39576,"(CONTRACTS OF CAD 100,000)"
10/06/2008,CAD,1.0218,-1.29%,-0.0128,3.28,0.45,123950,43276,25697,4755,32551,62810,80582,93262,43368,30688,"(CONTRACTS OF CAD 100,000)"
03/06/2008,CAD,1.0088,-1.45%,-0.0144,3.26,0.58,122819,63825,18087,2737,23136,75731,89698,96555,33121,26264,"(CONTRACTS OF CAD 100,000)"
27/05/2008,CAD,0.9944,-0.21%,-0.0021,3.02,0.38,127620,69636,19511,1851,21937,87714,93424,109076,34196,18544,"(CONTRACTS OF CAD 100,000)"
20/05/2008,CAD,0.9923,1.13%,0.0113,3.12,0.48,115665,53118,21700,2029,26201,73244,81348,96973,34317,18692,"(CONTRACTS OF CAD 100,000)"
13/05/2008,CAD,1.0036,-0.10%,-0.001,3.18,0.48,108527,46246,16837,2370,29641,71080,78257,90287,30270,18240,"(CONTRACTS OF CAD 100,000)"
06/05/2008,CAD,1.0026,1.02%,0.0102,3.2,0.43,114709,48104,16392,1848,33442,76584,83394,94824,31315,19885,"(CONTRACTS OF CAD 100,000)"
29/04/2008,CAD,1.0129,-0.61%,-0.006,3.35,0.45,98159,31816,24388,1947,38261,54704,72024,81039,26135,17120,"(CONTRACTS OF CAD 100,000)"
22/04/2008,CAD,1.0068,1.05%,0.0106,3.45,0.45,105665,43836,26466,2354,31165,60177,77355,88997,28310,16668,"(CONTRACTS OF CAD 100,000)"
15/04/2008,CAD,1.0175,-0.45%,-0.0045,3.48,0.73,104970,33518,28015,2534,43773,56688,79825,87237,25145,17733,"(CONTRACTS OF CAD 100,000)"
08/04/2008,CAD,1.0129,0.92%,0.0092,3.38,0.56,106562,37519,30955,2722,40782,55327,81023,89004,25539,17558,"(CONTRACTS OF CAD 100,000)"
01/04/2008,CAD,1.0223,-0.53%,-0.0053,3.42,0.66,100329,28382,27659,2353,42498,53557,73233,83569,27096,16760,"(CONTRACTS OF CAD 100,000)"
25/03/2008,CAD,1.0169,-2.49%,-0.0246,3.49,0.9,98867,28183,26005,2284,41813,54591,72280,82880,26587,15987,"(CONTRACTS OF CAD 100,000)"
18/03/2008,CAD,0.9922,-0.10%,-0.001,3.53,0.92,127275,43416,22517,6663,47073,78320,97152,107500,30123,19775,"(CONTRACTS OF CAD 100,000)"
11/03/2008,CAD,0.9912,0.24%,0.0024,3.56,0.79,117606,50353,21422,2427,31350,76213,84130,100062,33476,17544,"(CONTRACTS OF CAD 100,000)"
04/03/2008,CAD,0.9936,-1.09%,-0.0108,3.5,0.63,117986,60105,23699,2016,22427,75358,84548,101073,33438,16913,"(CONTRACTS OF CAD 100,000)"
26/02/2008,CAD,0.9829,3.36%,0.0342,3.7,0.63,110073,50323,24139,1865,26233,67921,78421,93925,31652,16148,"(CONTRACTS OF CAD 100,000)"
19/02/2008,CAD,1.0171,-1.63%,-0.0162,3.73,0.66,95614,33387,21440,1213,28562,53308,63162,75961,32452,19653,"(CONTRACTS OF CAD 100,000)"
12/02/2008,CAD,1.0008,0.60%,0.006,3.85,0.95,101187,43391,22956,1639,22399,60784,67429,85379,33758,15808,"(CONTRACTS OF CAD 100,000)"
05/02/2008,CAD,1.0068,-0.86%,-0.0086,3.72,0.76,93574,30603,20363,1776,32036,54769,64415,76908,29159,16666,"(CONTRACTS OF CAD 100,000)"
29/01/2008,CAD,0.9982,2.89%,0.0293,3.79,0.55,90907,25948,21653,1870,34077,48253,61895,71776,29012,19131,"(CONTRACTS OF CAD 100,000)"
22/01/2008,CAD,1.0279,-1.09%,-0.0109,4,0.68,86378,24463,16786,2761,30984,46841,58208,66388,28170,19990,"(CONTRACTS OF CAD 100,000)"
15/01/2008,CAD,1.0168,-1.01%,-0.0101,4.05,0.1,81827,22866,15101,3057,27093,46562,53016,64720,28811,17107,"(CONTRACTS OF CAD 100,000)"
08/01/2008,CAD,1.0066,-1.47%,-0.0146,4.28,-0.01,82454,31648,15224,2300,19093,48776,53041,66300,29413,16154,"(CONTRACTS OF CAD 100,000)"
31/12/2007,CAD,0.992,-0.72%,-0.0072,4.6,-0.13,83024,35655,12657,1405,18604,52488,55664,66550,27360,16474,"(CONTRACTS OF CAD 100,000)"
24/12/2007,CAD,0.9849,2.04%,0.0206,4.7,-0.07,77357,29959,15236,1405,18913,45440,50277,62081,27080,15276,"(CONTRACTS OF CAD 100,000)"
18/12/2007,CAD,1.0054,0.95%,0.0095,4.65,-0.34,121294,34895,11608,2909,54390,88867,92194,103384,29100,17910,"(CONTRACTS OF CAD 100,000)"
11/12/2007,CAD,1.015,-0.28%,-0.0028,4.81,-0.47,118951,30935,12271,3387,52568,85898,86890,101556,32061,17395,"(CONTRACTS OF CAD 100,000)"
04/12/2007,CAD,1.0122,-1.72%,-0.017,4.9,-0.29,114020,34194,18870,3673,46196,74920,84063,97463,29957,16557,"(CONTRACTS OF CAD 100,000)"
27/11/2007,CAD,0.9951,-1.64%,-0.0163,4.94,-0.12,112354,39532,10533,3155,42233,79718,84920,93406,27434,18948,"(CONTRACTS OF CAD 100,000)"
20/11/2007,CAD,0.979,-2.03%,-0.0201,4.88,-0.02,109533,41574,9282,3161,36064,76809,80799,89252,28734,20281,"(CONTRACTS OF CAD 100,000)"
13/11/2007,CAD,0.9595,-4.14%,-0.0405,4.78,-0.02,121478,55876,9153,2720,31485,89586,90081,101459,31397,20019,"(CONTRACTS OF CAD 100,000)"
06/11/2007,CAD,0.9214,3.30%,0.0335,4.75,-0.06,138502,75532,11944,2259,28379,97919,106170,112122,32332,26380,"(CONTRACTS OF CAD 100,000)"
30/10/2007,CAD,0.9528,1.36%,0.0137,4.78,0.05,137711,79052,10221,2187,23079,102463,104318,114871,33393,22840,"(CONTRACTS OF CAD 100,000)"
23/10/2007,CAD,0.9659,1.34%,0.0135,4.82,-0.06,140205,82625,11302,2525,20742,103728,105892,117555,34313,22650,"(CONTRACTS OF CAD 100,000)"
16/10/2007,CAD,0.979,0.16%,0.0016,4.9,-0.22,147428,90940,13991,2115,18037,109362,111092,125468,36336,21960,"(CONTRACTS OF CAD 100,000)"
09/10/2007,CAD,0.9806,1.76%,0.0178,4.88,-0.27,157628,99617,16616,2047,20303,119915,121967,138578,35661,19050,"(CONTRACTS OF CAD 100,000)"
02/10/2007,CAD,0.9982,0.68%,0.0068,4.86,-0.43,144193,87538,18359,1979,19290,104569,108807,124907,35386,19286,"(CONTRACTS OF CAD 100,000)"
25/09/2007,CAD,1.005,0.82%,0.0082,4.83,-0.41,126605,73042,13880,2179,18564,88538,93785,104597,32820,22008,"(CONTRACTS OF CAD 100,000)"
18/09/2007,CAD,1.0133,2.76%,0.028,5,-0.2,167680,88758,8930,7683,33172,125869,129613,142482,38067,25198,"(CONTRACTS OF CAD 100,000)"
11/09/2007,CAD,1.0421,0.59%,0.0059,5.18,-0.53,145388,78149,19395,4046,30595,103342,112790,126783,32598,18605,"(CONTRACTS OF CAD 100,000)"
04/09/2007,CAD,1.0483,1.61%,0.0162,5.01,-0.72,135940,73234,21889,3884,30583,91730,107701,117503,28239,18437,"(CONTRACTS OF CAD 100,000)"
28/08/2007,CAD,1.0654,-0.15%,-0.0015,4.83,-0.63,133856,68013,22919,2516,36520,88212,107049,113647,26807,20209,"(CONTRACTS OF CAD 100,000)"
21/08/2007,CAD,1.0638,0.35%,0.0035,4.76,-0.69,128591,60044,20011,3760,38332,85060,102136,108831,26455,19760,"(CONTRACTS OF CAD 100,000)"
14/08/2007,CAD,1.0675,-1.24%,-0.0123,4.7,-0.79,134044,66527,18717,3851,32100,88453,102478,111021,31566,23023,"(CONTRACTS OF CAD 100,000)"
07/08/2007,CAD,1.0544,1.18%,0.0119,4.58,-0.74,135946,71689,19751,2162,30031,95508,103882,117421,32064,18525,"(CONTRACTS OF CAD 100,000)"
31/07/2007,CAD,1.067,-3.02%,-0.0298,4.66,-0.64,133951,68138,18440,2914,28278,94909,99330,116263,34621,17688,"(CONTRACTS OF CAD 100,000)"
24/07/2007,CAD,1.0357,0.76%,0.0076,4.55,-0.76,158948,94483,17519,2833,25054,118037,122370,138389,36578,20559,"(CONTRACTS OF CAD 100,000)"
17/07/2007,CAD,1.0436,1.01%,0.0101,4.55,-0.76,150522,85281,18009,1537,27001,110312,113819,129858,36703,20664,"(CONTRACTS OF CAD 100,000)"
10/07/2007,CAD,1.0542,0.66%,0.0066,4.51,-0.81,143434,82889,15511,1483,22255,106004,106627,122998,36807,20436,"(CONTRACTS OF CAD 100,000)"
03/07/2007,CAD,1.0612,0.76%,0.0076,4.47,-0.82,143135,79653,14400,1489,26909,104004,108051,119893,35084,23242,"(CONTRACTS OF CAD 100,000)"
26/06/2007,CAD,1.0693,-0.65%,-0.0065,4.43,-0.83,139879,82053,13190,1479,25696,103754,109228,118423,30651,21456,"(CONTRACTS OF CAD 100,000)"
19/06/2007,CAD,1.0624,0.48%,0.0048,4.37,-0.92,243351,92321,33525,3633,115191,163257,211145,200415,32206,42936,"(CONTRACTS OF CAD 100,000)"
12/06/2007,CAD,1.0675,-0.38%,-0.0038,4.33,-0.95,232090,98404,36399,4125,95888,165135,198417,205659,33673,26431,"(CONTRACTS OF CAD 100,000)"
05/06/2007,CAD,1.0635,0.95%,0.0095,4.28,-1,184722,85481,41623,2771,60498,113313,148750,157707,35972,27015,"(CONTRACTS OF CAD 100,000)"
29/05/2007,CAD,1.0737,1.16%,0.0117,4.28,-1.01,186775,92150,40130,2357,53283,117771,147790,160258,38985,26517,"(CONTRACTS OF CAD 100,000)"
22/05/2007,CAD,1.0863,1.07%,0.0108,4.21,-1.05,172032,83891,44924,2194,51326,99885,137411,147003,34621,25029,"(CONTRACTS OF CAD 100,000)"
15/05/2007,CAD,1.0981,0.59%,0.0059,4.18,-1.08,168888,82619,39522,1358,50330,102977,134307,143857,34581,25031,"(CONTRACTS OF CAD 100,000)"
08/05/2007,CAD,1.1046,0.58%,0.0058,4.18,-1.08,146311,65117,47298,2702,46655,72121,114474,122121,31837,24190,"(CONTRACTS OF CAD 100,000)"
01/05/2007,CAD,1.111,0.91%,0.0091,4.19,-1.07,138029,52582,43731,2873,49392,67864,104847,114468,33182,23561,"(CONTRACTS OF CAD 100,000)"
24/04/2007,CAD,1.1212,0.78%,0.0078,4.19,-1.06,121786,39017,40648,3041,48384,54708,90442,98397,31344,23389,"(CONTRACTS OF CAD 100,000)"
17/04/2007,CAD,1.13,1.49%,0.015,4.18,-1.09,114610,25549,41540,3181,56053,45950,84783,90671,29827,23939,"(CONTRACTS OF CAD 100,000)"
10/04/2007,CAD,1.1471,0.98%,0.0098,4.18,-1.08,110266,23062,38626,2729,56080,43876,81871,85231,28395,25035,"(CONTRACTS OF CAD 100,000)"
03/04/2007,CAD,1.1584,-0.13%,-0.0013,4.18,-1.07,113096,22068,57233,2232,59240,29139,83540,88604,29556,24492,"(CONTRACTS OF CAD 100,000)"
27/03/2007,CAD,1.1569,0.36%,0.0036,4.18,-1.07,114484,24613,56595,2011,60928,28841,87552,87447,26932,27037,"(CONTRACTS OF CAD 100,000)"
20/03/2007,CAD,1.1611,1.11%,0.0111,4.17,-1.08,161700,21021,72174,7578,107201,42555,135800,122307,25900,39393,"(CONTRACTS OF CAD 100,000)"
13/03/2007,CAD,1.1741,0.16%,0.0016,4.16,-1.09,159619,15758,89897,6134,110907,35249,132799,131280,26820,28339,"(CONTRACTS OF CAD 100,000)"
06/03/2007,CAD,1.176,-0.80%,-0.0079,4.19,-1.07,156871,21585,96510,2969,103674,31004,128228,130483,28643,26388,"(CONTRACTS OF CAD 100,000)"
27/02/2007,CAD,1.1667,0.24%,0.0024,4.2,-1.05,137776,17563,73987,2665,87030,32646,107258,109298,30518,28478,"(CONTRACTS OF CAD 100,000)"
20/02/2007,CAD,1.1695,-0.27%,-0.0027,4.2,-1.1,141561,17005,82431,2375,91971,28388,111351,113194,30210,28367,"(CONTRACTS OF CAD 100,000)"
13/02/2007,CAD,1.1664,1.34%,0.0135,4.21,-1.09,140722,19930,76625,2184,88942,32475,111056,111284,29666,29438,"(CONTRACTS OF CAD 100,000)"
06/02/2007,CAD,1.1823,-0.18%,-0.0018,4.21,-1.09,154591,18927,99573,2942,100689,23605,122558,126120,32033,28471,"(CONTRACTS OF CAD 100,000)"
30/01/2007,CAD,1.1802,-0.01%,-0.0001,4.21,-1.09,146376,21650,92526,2409,93856,22340,117915,117275,28461,29101,"(CONTRACTS OF CAD 100,000)"
23/01/2007,CAD,1.1801,-0.34%,-0.0034,4.21,-1.06,152395,22471,100328,2108,98006,20880,122585,123316,29810,29079,"(CONTRACTS OF 100,000 CANADIAN DOLLARS)"
16/01/2007,CAD,1.1761,0.01%,0.0001,4.2,-1.06,152438,22030,100997,2061,99999,20027,124090,123085,28348,29353,"(CONTRACTS OF 100,000 CANADIAN DOLLARS)"
09/01/2007,CAD,1.1762,-1.07%,-0.0107,4.2,-1.09,155922,20637,105543,1991,105129,18080,127757,125614,28165,30308,"(CONTRACTS OF 100,000 CANADIAN DOLLARS)"
03/01/2007,CAD,1.1637,-0.28%,-0.0028,4.19,-1.07,148644,23583,97851,1905,96263,18737,121751,118493,26893,30151,"(CONTRACTS OF 100,000 CANADIAN DOLLARS)"
26/12/2006,CAD,1.1604,-0.71%,-0.0071,4.21,-1.09,136963,21479,87773,1793,89638,18964,112910,108530,24053,28433,"(CONTRACTS OF 100,000 CANADIAN DOLLARS)"
19/12/2006,CAD,1.1522,-0.01%,-0.0001,4.21,-1.09,183332,27186,84578,2347,118141,64063,147674,150988,35658,32344,"(CONTRACTS OF 100,000 CANADIAN DOLLARS)"
12/12/2006,CAD,1.1521,-0.93%,-0.0092,4.2,-1.09,165716,26173,78181,5923,105049,52332,137145,136436,28571,29280,"(CONTRACTS OF 100,000 CANADIAN DOLLARS)"
05/12/2006,CAD,1.1415,-1.01%,-0.01,4.18,-1.1,131624,24557,71036,1656,77624,31126,103837,103818,27787,27806,"(CONTRACTS OF 100,000 CANADIAN DOLLARS)"
28/11/2006,CAD,1.1301,1.35%,0.0136,4.19,-1.08,124553,26934,67216,1667,69001,30727,97602,99610,26951,24943,"(CONTRACTS OF 100,000 CANADIAN DOLLARS)"
21/11/2006,CAD,1.1456,-0.72%,-0.0072,4.19,-1.07,138113,23236,82129,1678,81123,29095,106037,112902,32076,25211,"(CONTRACTS OF 100,000 CANADIAN DOLLARS)"
14/11/2006,CAD,1.1374,-0.74%,-0.0073,4.2,-1.09,129537,25902,73277,1400,70328,32426,97630,107103,31907,22434,"(CONTRACTS OF 100,000 CANADIAN DOLLARS)"
07/11/2006,CAD,1.1291,-0.61%,-0.0061,4.23,-1.05,103426,24999,45341,1107,48484,36062,74590,82510,28836,20916,"(CONTRACTS OF 100,000 CANADIAN DOLLARS)"
31/10/2006,CAD,1.1222,0.40%,0.004,4.22,-1.05,104350,23818,47496,1431,50020,33744,75269,82671,29081,21679,"(CONTRACTS OF 100,000 CANADIAN DOLLARS)"
24/10/2006,CAD,1.1267,1.24%,0.0124,4.24,-1.04,100203,24985,39218,1093,45246,37415,71324,77726,28879,22477,"(CONTRACTS OF 100,000 CANADIAN DOLLARS)"
17/10/2006,CAD,1.1408,-0.67%,-0.0067,4.24,-1.03,110173,26833,51331,1393,53383,32888,81609,85612,28564,24561,"(CONTRACTS OF 100,000 CANADIAN DOLLARS)"
10/10/2006,CAD,1.1332,-0.98%,-0.0098,4.22,-1.09,91193,34272,32413,1350,26819,37285,62441,71048,28752,20145,"(CONTRACTS OF 100,000 CANADIAN DOLLARS)"
03/10/2006,CAD,1.1222,-0.84%,-0.0083,4.23,-1.08,100141,45535,36256,1344,24368,43043,71247,80643,28894,19498,"(CONTRACTS OF 100,000 CANADIAN DOLLARS)"
26/09/2006,CAD,1.1129,1.26%,0.0127,4.21,-1.08,94128,38542,32032,1093,25052,39995,64687,73120,29441,21008,"(CONTRACTS OF 100,000 CANADIAN DOLLARS)"
19/09/2006,CAD,1.1271,-0.65%,-0.0065,4.23,-1.1,138838,41043,40188,1750,68379,75332,111172,117270,27666,21568,"(CONTRACTS OF 100,000 CANADIAN DOLLARS)"
12/09/2006,CAD,1.1198,-0.76%,-0.0075,4.24,-1.1,138181,37739,22957,2217,62313,92568,102269,117742,35912,20439,"(CONTRACTS OF 100,000 CANADIAN DOLLARS)"
05/09/2006,CAD,1.1114,-0.36%,-0.0036,4.24,-1.08,111705,49440,21974,2812,25144,68572,77396,93358,34309,18347,"(CONTRACTS OF 100,000 CANADIAN DOLLARS)"
29/08/2006,CAD,1.1074,0.72%,0.0072,4.25,-1.09,106142,45977,15372,2366,23495,69190,71838,86928,34304,19214,"(CONTRACTS OF 100,000 CANADIAN DOLLARS)"
22/08/2006,CAD,1.1154,0.52%,0.0052,4.25,-1.09,86667,27805,12312,1703,22640,53596,52148,67611,34519,19056,"(CONTRACTS OF 100,000 CANADIAN DOLLARS)"
15/08/2006,CAD,1.1212,0.13%,0.0013,4.25,-1.1,86815,27206,18609,1135,24981,47565,53322,67309,33493,19506,"(CONTRACTS OF 100,000 CANADIAN DOLLARS)"
08/08/2006,CAD,1.1227,0.70%,0.007,4.25,-1.14,82510,23185,13355,1135,21619,51755,45939,66245,36571,16265,"(CONTRACTS OF 100,000 CANADIAN DOLLARS)"
01/08/2006,CAD,1.1306,0.95%,0.0095,4.26,-1.16,86048,18809,26225,1135,31501,40698,51445,68058,34603,17990,"(CONTRACTS OF 100,000 CANADIAN DOLLARS)"
25/07/2006,CAD,1.1414,-0.42%,-0.0042,4.26,-1.17,91963,23613,29032,1657,31421,41951,56691,72640,35272,19323,"(CONTRACTS OF 100,000 CANADIAN DOLLARS)"
18/07/2006,CAD,1.1366,-0.45%,-0.0045,4.29,-1.16,83415,23302,14018,1561,24893,48876,49756,64455,33659,18960,"(CONTRACTS OF 100,000 CANADIAN DOLLARS)"
11/07/2006,CAD,1.1315,-2.18%,-0.0215,4.32,-1.14,92978,29942,18321,1528,24501,55460,55971,75309,37007,17669,"(CONTRACTS OF 100,000 CANADIAN DOLLARS)"
03/07/2006,CAD,1.1074,1.40%,0.0141,4.31,-1.12,93841,42762,6315,1083,14847,71446,58692,78844,35149,14997,"(CONTRACTS OF 100,000 CANADIAN DOLLARS)"
27/06/2006,CAD,1.1231,-0.47%,-0.0046,4.31,-1.15,89791,38165,7856,1083,15974,65982,55222,74921,34569,14870,"(CONTRACTS OF 100,000 CANADIAN DOLLARS)"
20/06/2006,CAD,1.1179,-0.45%,-0.0045,4.32,-1.06,123446,37024,13046,1637,51442,92859,90103,107542,33343,15904,"(CONTRACTS OF 100,000 CANADIAN DOLLARS)"
13/06/2006,CAD,1.1129,0.04%,0.0004,4.28,-1,129707,46579,13228,2212,44715,95815,93506,111255,36201,18452,"(CONTRACTS OF 100,000 CANADIAN DOLLARS)"
06/06/2006,CAD,1.1133,-1.37%,-0.0136,4.25,-0.97,118798,44443,21581,2576,34859,76060,81878,100217,36920,18581,"(CONTRACTS OF 100,000 CANADIAN DOLLARS)"
30/05/2006,CAD,1.0983,2.34%,0.0237,4.2,-0.98,109252,45937,14230,2912,25988,74774,74837,91916,34415,17336,"(CONTRACTS OF 100,000 CANADIAN DOLLARS)"
23/05/2006,CAD,1.1246,-1.66%,-0.0165,4.18,-0.97,111976,36980,21278,2183,36757,71810,75920,95271,36056,16705,"(CONTRACTS OF 100,000 CANADIAN DOLLARS)"
16/05/2006,CAD,1.1062,-0.62%,-0.0062,4.13,-0.99,117839,46060,26532,1304,32921,72276,80285,100112,37554,17727,"(CONTRACTS OF 100,000 CANADIAN DOLLARS)"
09/05/2006,CAD,1.0994,0.64%,0.0064,4.14,-0.97,121046,52111,23238,1288,29342,77518,82741,102044,38305,19002,"(CONTRACTS OF 100,000 CANADIAN DOLLARS)"
02/05/2006,CAD,1.1065,2.20%,0.0223,4.13,-0.97,110279,48997,16845,1542,29719,79539,80258,97926,30021,12353,"(CONTRACTS OF 100,000 CANADIAN DOLLARS)"
25/04/2006,CAD,1.1314,0.81%,0.0081,4.04,-1.01,100591,31949,16326,2249,31603,67108,65801,85683,34790,14908,"(CONTRACTS OF 100,000 CANADIAN DOLLARS)"
18/04/2006,CAD,1.1406,0.18%,0.0018,4.02,-1.01,93170,23225,16307,1467,36184,59243,60876,77017,32294,16153,"(CONTRACTS OF 100,000 CANADIAN DOLLARS)"
11/04/2006,CAD,1.1427,1.71%,0.0173,4,-1,87690,24639,10697,1531,29815,58926,55985,71154,31705,16536,"(CONTRACTS OF 100,000 CANADIAN DOLLARS)"
04/04/2006,CAD,1.1626,0.70%,0.007,3.9,-1.07,84301,12081,16227,1489,37058,50463,50628,68179,33673,16122,"(CONTRACTS OF 100,000 CANADIAN DOLLARS)"
28/03/2006,CAD,1.1708,-0.63%,-0.0063,3.84,-1.08,87356,13274,21085,1432,37502,48602,52208,71119,35148,16237,"(CONTRACTS OF 100,000 CANADIAN DOLLARS)"
21/03/2006,CAD,1.1635,-0.63%,-0.0063,3.78,-1.08,85219,18295,22037,1426,32225,46797,51946,70260,33273,14959,"(CONTRACTS OF 100,000 CANADIAN DOLLARS)"
14/03/2006,CAD,1.1562,-0.57%,-0.0056,3.82,-1.04,125712,33979,19958,3137,50076,89290,87192,112385,38520,13327,"(CONTRACTS OF 100,000 CANADIAN DOLLARS)"
07/03/2006,CAD,1.1497,-1.16%,-0.0115,3.81,-0.98,137195,55226,13903,1730,40234,105162,97190,120795,40005,16400,"(CONTRACTS OF 100,000 CANADIAN DOLLARS)"
28/02/2006,CAD,1.1365,0.88%,0.0088,3.8,-0.93,124984,54931,14297,1609,27081,89171,83621,105077,41363,19907,"(CONTRACTS OF 100,000 CANADIAN DOLLARS)"
21/02/2006,CAD,1.1466,0.62%,0.0062,3.72,-1,115876,46710,11513,1712,29696,87592,78118,100817,37758,15059,"(CONTRACTS OF 100,000 CANADIAN DOLLARS)"
14/02/2006,CAD,1.1537,-0.04%,-0.0004,3.7,-0.98,118357,52220,11756,1622,27397,89061,81239,102439,37118,15918,"(CONTRACTS OF 100,000 CANADIAN DOLLARS)"
07/02/2006,CAD,1.1532,-1.22%,-0.0121,3.66,-0.98,121889,56298,11453,1738,24823,93013,82859,106204,39030,15685,"(CONTRACTS OF 100,000 CANADIAN DOLLARS)"
31/01/2006,CAD,1.1393,1.14%,0.0114,3.59,-1.09,117314,50705,13221,1561,27053,85577,79319,100359,37995,16955,"(CONTRACTS OF 100,000 CANADIAN DOLLARS)"
24/01/2006,CAD,1.1524,0.95%,0.0096,3.55,-0.99,102095,35048,7915,975,28685,76880,64708,85770,37387,16325,"(CONTRACTS OF 100,000 CANADIAN DOLLARS)"
17/01/2006,CAD,1.1635,0.17%,0.0017,3.51,-1.06,101952,39506,12573,715,27012,76863,67233,90151,34719,11801,"(CONTRACTS OF 100,000 CANADIAN DOLLARS)"
10/01/2006,CAD,1.1655,-0.88%,-0.0088,3.44,-1.09,98344,32628,9311,715,27623,75711,60966,85737,37378,12607,"(CONTRACTS OF 100,000 CANADIAN DOLLARS)"
03/01/2006,CAD,1.1553,1.51%,0.0152,3.37,-1.16,105401,45749,9062,727,24990,81233,71466,91022,33935,14379,"(CONTRACTS OF 100,000 CANADIAN DOLLARS)"
27/12/2005,CAD,1.173,-0.11%,-0.0011,3.37,-1.14,103040,49468,7176,727,21536,80374,71731,88277,31309,14763,"(CONTRACTS OF 100,000 CANADIAN DOLLARS)"
20/12/2005,CAD,1.1717,-1.79%,-0.0177,3.37,-1.11,137619,55542,7431,1889,46157,103345,103588,112665,34031,24954,"(CONTRACTS OF 100,000 CANADIAN DOLLARS)"
13/12/2005,CAD,1.1511,0.50%,0.005,3.35,-1.05,142450,66468,10285,3291,33897,111552,103656,125128,38794,17322,"(CONTRACTS OF 100,000 CANADIAN DOLLARS)"
06/12/2005,CAD,1.1569,0.99%,0.01,3.31,-1.07,118337,49064,11747,1920,29155,88453,80139,102120,38198,16217,"(CONTRACTS OF 100,000 CANADIAN DOLLARS)"
29/11/2005,CAD,1.1685,0.43%,0.0044,3.27,-1.06,115153,42311,13301,1440,37340,84289,81091,99030,34062,16123,"(CONTRACTS OF 100,000 CANADIAN DOLLARS)"
22/11/2005,CAD,1.1736,1.57%,0.0158,3.26,-1.07,106006,33585,17860,1346,39485,69963,74416,89169,31590,16837,"(CONTRACTS OF 100,000 CANADIAN DOLLARS)"
15/11/2005,CAD,1.1923,-0.57%,-0.0057,3.2,-1.09,102550,32487,12318,731,37885,71831,71103,84880,31447,17670,"(CONTRACTS OF 100,000 CANADIAN DOLLARS)"
08/11/2005,CAD,1.1855,-0.90%,-0.009,3.16,-1.1,104351,37234,10894,775,36159,64385,74168,76054,30183,28297,"(CONTRACTS OF 100,000 CANADIAN DOLLARS)"
01/11/2005,CAD,1.1749,-0.08%,-0.0008,3.13,-1.08,108226,44435,7275,792,30161,82796,75388,90863,32838,17363,"(CONTRACTS OF 100,000 CANADIAN DOLLARS)"
25/10/2005,CAD,1.174,0.27%,0.0027,3.08,-1.08,104625,43849,6904,793,27732,79945,72374,87642,32251,16983,"(CONTRACTS OF 100,000 CANADIAN DOLLARS)"
18/10/2005,CAD,1.1772,-0.10%,-0.001,3.01,-1.09,112354,51259,8447,781,26795,87395,78835,96623,33519,15731,"(CONTRACTS OF 100,000 CANADIAN DOLLARS)"
11/10/2005,CAD,1.176,-0.31%,-0.0031,2.98,-1.07,109147,50532,6941,785,25071,82681,76388,90407,32759,18740,"(CONTRACTS OF 100,000 CANADIAN DOLLARS)"
04/10/2005,CAD,1.1724,0.47%,0.0047,2.94,-1.08,108178,47026,8995,762,25285,82651,73073,92408,35105,15770,"(CONTRACTS OF 100,000 CANADIAN DOLLARS)"
27/09/2005,CAD,1.1779,-0.67%,-0.0066,2.87,-1.06,110057,50520,7424,689,24420,85327,75629,93440,34428,16617,"(CONTRACTS OF 100,000 CANADIAN DOLLARS)"
20/09/2005,CAD,1.1701,1.01%,0.0101,2.84,-1.03,148171,45536,19033,2731,62809,104222,111076,125986,37095,22185,"(CONTRACTS OF 100,000 CANADIAN DOLLARS)"
13/09/2005,CAD,1.182,0.64%,0.0064,2.8,-0.96,141219,45957,16365,1649,59669,105623,107275,123637,33944,17582,"(CONTRACTS OF 100,000 CANADIAN DOLLARS)"
06/09/2005,CAD,1.1896,0.15%,0.0015,2.71,-0.98,117451,46423,16430,1049,42369,88034,89841,105513,27610,11938,"(CONTRACTS OF 100,000 CANADIAN DOLLARS)"
30/08/2005,CAD,1.1914,0.51%,0.0051,2.81,-0.95,111153,44904,15990,608,38880,81540,84392,98138,26761,13015,"(CONTRACTS OF 100,000 CANADIAN DOLLARS)"
23/08/2005,CAD,1.1975,0.07%,0.0007,2.72,-1.06,107851,41543,17000,719,33159,75499,75421,93218,32430,14633,"(CONTRACTS OF 100,000 CANADIAN DOLLARS)"
16/08/2005,CAD,1.1983,1.15%,0.0115,2.7,-1.04,109505,44042,17995,540,30837,76307,75419,94842,34086,14663,"(CONTRACTS OF 100,000 CANADIAN DOLLARS)"
09/08/2005,CAD,1.2122,0.52%,0.0052,2.64,-1.05,92585,33587,19373,540,27978,58661,62105,78574,30480,14011,"(CONTRACTS OF 100,000 CANADIAN DOLLARS)"
02/08/2005,CAD,1.2185,0.93%,0.0093,2.6,-1.06,87906,28966,16802,540,29385,53362,58891,70704,29015,17202,"(CONTRACTS OF 100,000 CANADIAN DOLLARS)"
26/07/2005,CAD,1.2299,-0.86%,-0.0086,2.56,-1.06,90753,31840,14321,543,27243,62482,59626,77346,31127,13407,"(CONTRACTS OF 100,000 CANADIAN DOLLARS)"
19/07/2005,CAD,1.2194,-1.30%,-0.013,2.56,-1.01,91255,35684,9859,543,23890,65844,60117,76246,31138,15009,"(CONTRACTS OF 100,000 CANADIAN DOLLARS)"
12/07/2005,CAD,1.2037,3.15%,0.032,2.56,-0.98,91423,35282,12079,540,25043,62647,60865,75266,30558,16157,"(CONTRACTS OF 100,000 CANADIAN DOLLARS)"
05/07/2005,CAD,1.2428,-0.87%,-0.0086,2.58,-0.95,70074,19364,15276,540,22184,38018,42088,53834,27986,16240,"(CONTRACTS OF 100,000 CANADIAN DOLLARS)"
28/06/2005,CAD,1.2321,0.01%,0.0001,2.49,-0.92,71522,20959,18675,591,20187,37461,41737,56727,29785,14795,"(CONTRACTS OF 100,000 CANADIAN DOLLARS)"
21/06/2005,CAD,1.2322,1.60%,0.0161,2.56,-0.87,67143,16872,16588,586,20368,34699,37826,51873,29317,15270,"(CONTRACTS OF 100,000 CANADIAN DOLLARS)"
14/06/2005,CAD,1.2522,-0.50%,-0.005,2.57,-0.78,63187,10932,28521,647,26421,15297,38000,44465,25187,18722,"(CONTRACTS OF 100,000 CANADIAN DOLLARS)"
07/06/2005,CAD,1.246,0.64%,0.0064,2.53,-0.77,94186,9675,36236,595,56932,36200,67202,73031,26984,21155,"(CONTRACTS OF 100,000 CANADIAN DOLLARS)"
31/05/2005,CAD,1.254,0.38%,0.0038,2.51,-0.76,94700,10524,41764,647,60610,30914,71781,73325,22919,21375,"(CONTRACTS OF 100,000 CANADIAN DOLLARS)"
24/05/2005,CAD,1.2588,0.44%,0.0044,2.5,-0.69,96833,9806,42690,587,63398,30943,73791,74220,23042,22613,"(CONTRACTS OF 100,000 CANADIAN DOLLARS)"
17/05/2005,CAD,1.2643,-2.28%,-0.0226,2.54,-0.63,99089,11662,45154,1271,62833,28120,75766,74545,23323,24544,"(CONTRACTS OF 100,000 CANADIAN DOLLARS)"
10/05/2005,CAD,1.2361,1.34%,0.0135,2.54,-0.64,86866,11651,39446,617,50106,24688,62374,64751,24492,22115,"(CONTRACTS OF 100,000 CANADIAN DOLLARS)"
03/05/2005,CAD,1.2529,-0.63%,-0.0062,2.53,-0.6,93278,12434,45755,588,56509,23718,69531,70061,23747,23217,"(CONTRACTS OF 100,000 CANADIAN DOLLARS)"
26/04/2005,CAD,1.2451,-0.68%,-0.0068,2.54,-0.56,85837,13776,38495,586,46257,28509,60619,67590,25218,18247,"(CONTRACTS OF 100,000 CANADIAN DOLLARS)"
19/04/2005,CAD,1.2367,0.04%,0.0004,2.52,-0.5,76771,13905,30263,586,36714,29877,51205,60726,25566,16045,"(CONTRACTS OF 100,000 CANADIAN DOLLARS)"
12/04/2005,CAD,1.2372,-1.55%,-0.0154,2.55,-0.54,69292,15951,23385,617,24234,30277,40802,54279,28490,15013,"(CONTRACTS OF 100,000 CANADIAN DOLLARS)"
05/04/2005,CAD,1.2183,-0.58%,-0.0058,2.59,-0.42,80302,35799,10124,617,13043,55397,49459,66138,30843,14164,"(CONTRACTS OF 100,000 CANADIAN DOLLARS)"
29/03/2005,CAD,1.2113,-0.27%,-0.0027,2.6,-0.44,81193,35455,8765,630,14226,56091,50311,65486,30882,15707,"(CONTRACTS OF 100,000 CANADIAN DOLLARS)"
22/03/2005,CAD,1.208,-0.01%,-0.0001,2.53,-0.43,89844,43143,11596,625,14685,62757,58453,74978,31391,14866,"(CONTRACTS OF 100,000 CANADIAN DOLLARS)"
15/03/2005,CAD,1.2079,0.50%,0.005,2.58,-0.36,125191,36259,10109,904,52191,77424,89354,88437,35837,36754,"(CONTRACTS OF 100,000 CANADIAN DOLLARS)"
08/03/2005,CAD,1.214,2.11%,0.0214,2.5,-0.35,105920,17563,14234,619,60248,76330,78430,91183,27490,14737,"(CONTRACTS OF 100,000 CANADIAN DOLLARS)"
01/03/2005,CAD,1.2402,-1.29%,-0.0128,2.52,-0.33,95644,11793,18622,963,56547,60041,69303,79626,26341,16018,"(CONTRACTS OF 100,000 CANADIAN DOLLARS)"
22/02/2005,CAD,1.2244,0.49%,0.0049,2.5,-0.33,88275,11275,14416,1152,50404,59250,62831,74818,25444,13457,"(CONTRACTS OF 100,000 CANADIAN DOLLARS)"
15/02/2005,CAD,1.2304,1.28%,0.0128,2.46,-0.28,83368,10760,16067,997,46093,50568,57850,67632,25518,15736,"(CONTRACTS OF 100,000 CANADIAN DOLLARS)"
08/02/2005,CAD,1.2463,-0.87%,-0.0086,2.49,-0.2,82670,10606,17971,649,46446,46639,57701,65259,24969,17411,"(CONTRACTS OF 100,000 CANADIAN DOLLARS)"
01/02/2005,CAD,1.2356,-0.02%,-0.0002,2.51,-0.2,77006,12127,10858,396,37013,50419,49536,61673,27470,15333,"(CONTRACTS OF 100,000 CANADIAN DOLLARS)"
25/01/2005,CAD,1.2354,-0.96%,-0.0096,2.48,-0.16,78850,17352,14699,453,33085,47224,50890,62376,27960,16474,"(CONTRACTS OF 100,000 CANADIAN DOLLARS)"
18/01/2005,CAD,1.2236,-0.46%,-0.0046,2.52,-0.08,77385,19773,14273,403,29262,49283,49438,63959,27947,13426,"(CONTRACTS OF 100,000 CANADIAN DOLLARS)"
11/01/2005,CAD,1.218,0.35%,0.0035,2.55,-0.02,69850,19317,9424,408,22579,47479,42304,57311,27546,12539,"(CONTRACTS OF 100,000 CANADIAN DOLLARS)"
04/01/2005,CAD,1.2223,-0.43%,-0.0043,2.53,0.01,71055,20448,10786,341,20814,47151,41603,58278,29452,12777,"(CONTRACTS OF 100,000 CANADIAN DOLLARS)"
28/12/2004,CAD,1.2171,1.08%,0.0109,2.57,0.11,66171,19215,13081,366,17599,41225,37180,54672,28991,11499,"(CONTRACTS OF 100,000 CANADIAN DOLLARS)"
21/12/2004,CAD,1.2304,0.40%,0.004,2.56,0.1,65452,20422,14146,366,15273,38006,36061,52518,29391,12934,"(CONTRACTS OF 100,000 CANADIAN DOLLARS)"
14/12/2004,CAD,1.2353,-2.28%,-0.0225,2.55,0.14,101313,21889,12812,368,50827,66112,73084,79292,28229,22021,"(CONTRACTS OF 100,000 CANADIAN DOLLARS)"
07/12/2004,CAD,1.2078,-1.89%,-0.0187,2.5,0.13,108956,30867,12497,368,43844,77830,75079,90695,33877,18261,"(CONTRACTS OF 100,000 CANADIAN DOLLARS)"
30/11/2004,CAD,1.1854,-0.10%,-0.001,2.59,0.25,105893,35634,12003,546,34870,79056,71050,91605,34843,14288,"(CONTRACTS OF 100,000 CANADIAN DOLLARS)"
23/11/2004,CAD,1.1842,0.98%,0.0098,2.67,0.39,105371,37207,7736,349,30669,82232,68225,90317,37146,15054,"(CONTRACTS OF 100,000 CANADIAN DOLLARS)"
16/11/2004,CAD,1.1959,0.33%,0.0033,2.67,0.43,108544,40552,7217,487,30663,85733,71702,93437,36842,15107,"(CONTRACTS OF 100,000 CANADIAN DOLLARS)"
09/11/2004,CAD,1.1998,2.03%,0.0205,2.65,0.44,109798,41418,6446,273,31107,86945,72798,93664,37000,16134,"(CONTRACTS OF 100,000 CANADIAN DOLLARS)"
02/11/2004,CAD,1.2246,0.04%,0.0004,2.63,0.53,115675,45896,6204,133,32701,94595,78730,100932,36945,14743,"(CONTRACTS OF 100,000 CANADIAN DOLLARS)"
26/10/2004,CAD,1.2251,2.69%,0.0273,2.52,0.48,109721,42987,6764,103,29841,87885,72931,94752,36790,14969,"(CONTRACTS OF 100,000 CANADIAN DOLLARS)"
19/10/2004,CAD,1.259,-0.24%,-0.0024,2.49,0.49,116035,49034,9014,83,27815,89771,76932,98868,39103,17167,"(CONTRACTS OF 100,000 CANADIAN DOLLARS)"
12/10/2004,CAD,1.256,0.33%,0.0033,2.5,0.53,117114,56875,7489,83,24642,91165,81600,98737,35514,18377,"(CONTRACTS OF 100,000 CANADIAN DOLLARS)"
05/10/2004,CAD,1.2602,0.91%,0.0092,2.45,0.48,111202,53036,7868,91,24327,87665,77454,95624,33748,15578,"(CONTRACTS OF 100,000 CANADIAN DOLLARS)"
28/09/2004,CAD,1.2718,1.14%,0.0115,2.41,0.54,98326,52716,5960,55,12567,77456,65338,83471,32988,14855,"(CONTRACTS OF 100,000 CANADIAN DOLLARS)"
21/09/2004,CAD,1.2865,0.55%,0.0055,2.35,0.51,89047,44615,5216,40,11865,71035,56520,76291,32527,12756,"(CONTRACTS OF 100,000 CANADIAN DOLLARS)"
14/09/2004,CAD,1.2936,-0.46%,-0.0046,2.3,0.51,111785,50371,5719,5,28488,90831,78864,96555,32921,15230,"(CONTRACTS OF 100,000 CANADIAN DOLLARS)"
07/09/2004,CAD,1.2877,1.87%,0.0189,2.28,0.53,107167,46379,5076,829,26655,83029,73863,88934,33304,18233,"(CONTRACTS OF 100,000 CANADIAN DOLLARS)"
31/08/2004,CAD,1.3123,-0.43%,-0.0043,2.17,0.46,86184,35306,6168,4,20692,67453,56002,73625,30182,12559,"(CONTRACTS OF 100,000 CANADIAN DOLLARS)"
24/08/2004,CAD,1.3067,-0.02%,-0.0002,2.08,0.44,92045,40507,6764,84,19234,71974,59825,78822,32220,13223,"(CONTRACTS OF 100,000 CANADIAN DOLLARS)"
17/08/2004,CAD,1.3065,1.08%,0.0108,2.06,0.34,86804,37979,6885,74,16636,65286,54689,72245,32115,14559,"(CONTRACTS OF 100,000 CANADIAN DOLLARS)"
10/08/2004,CAD,1.3207,-0.26%,-0.0026,2.01,0.34,80273,33093,6454,66,17745,59900,50904,66420,29369,13853,"(CONTRACTS OF 100,000 CANADIAN DOLLARS)"
03/08/2004,CAD,1.3173,1.13%,0.0114,2.05,0.34,76946,29499,5898,15,18060,56861,47574,62774,29372,14172,"(CONTRACTS OF 100,000 CANADIAN DOLLARS)"
27/07/2004,CAD,1.3324,-1.45%,-0.0144,2.04,0.47,75905,31026,5311,63,16201,56748,47290,62122,28615,13783,"(CONTRACTS OF 100,000 CANADIAN DOLLARS)"
20/07/2004,CAD,1.3133,0.41%,0.0041,2.03,0.51,82944,36916,5938,142,15734,61096,52792,67176,30152,15768,"(CONTRACTS OF 100,000 CANADIAN DOLLARS)"
13/07/2004,CAD,1.3187,0.68%,0.0068,2,0.48,72639,30113,6237,4,15040,53202,45157,59443,27482,13196,"(CONTRACTS OF 100,000 CANADIAN DOLLARS)"
06/07/2004,CAD,1.3277,1.29%,0.0129,1.98,0.46,62007,18933,7612,358,15425,38100,34716,46070,27291,15937,"(CONTRACTS OF 100,000 CANADIAN DOLLARS)"
29/06/2004,CAD,1.345,0.94%,0.0094,2.01,0.47,59016,16877,16612,18,17734,29074,34629,45704,24387,13312,"(CONTRACTS OF 100,000 CANADIAN DOLLARS)"
22/06/2004,CAD,1.3577,0.83%,0.0083,2.06,0.6,58449,12265,27470,38,22618,15392,34921,42900,23528,15549,"(CONTRACTS OF 100,000 CANADIAN DOLLARS)"
15/06/2004,CAD,1.369,-1.44%,-0.0143,2.06,0.59,84500,14039,25029,134,45349,39757,59522,64920,24978,19580,"(CONTRACTS OF 100,000 CANADIAN DOLLARS)"
08/06/2004,CAD,1.3496,1.28%,0.0129,2.03,0.7,77098,13149,18041,83,39363,41041,52595,59165,24503,17933,"(CONTRACTS OF 100,000 CANADIAN DOLLARS)"
01/06/2004,CAD,1.3671,0.33%,0.0033,2,0.79,82138,13430,27706,101,44522,35658,58053,63465,24085,18673,"(CONTRACTS OF 100,000 CANADIAN DOLLARS)"
25/05/2004,CAD,1.3716,1.29%,0.013,2.01,0.77,82269,13154,32331,118,43484,30913,56756,63362,25513,18907,"(CONTRACTS OF 100,000 CANADIAN DOLLARS)"
18/05/2004,CAD,1.3895,-0.30%,-0.003,2,0.84,91114,13380,42114,141,52164,29627,65685,71882,25429,19232,"(CONTRACTS OF 100,000 CANADIAN DOLLARS)"
11/05/2004,CAD,1.3853,-1.12%,-0.0111,2,0.86,86362,13705,39353,137,46258,26172,60100,65662,26262,20700,"(CONTRACTS OF 100,000 CANADIAN DOLLARS)"
04/05/2004,CAD,1.37,-1.38%,-0.0137,1.95,0.88,81767,13178,32569,34,44669,29194,57881,61797,23886,19970,"(CONTRACTS OF 100,000 CANADIAN DOLLARS)"
27/04/2004,CAD,1.3514,0.32%,0.0033,1.96,0.89,70976,12310,21935,64,32715,31461,45089,53460,25887,17516,"(CONTRACTS OF 100,000 CANADIAN DOLLARS)"
20/04/2004,CAD,1.3558,-1.54%,-0.0152,1.96,0.88,65409,14206,14758,117,25086,36245,39409,51120,26000,14289,"(CONTRACTS OF 100,000 CANADIAN DOLLARS)"
12/04/2004,CAD,1.3353,-2.01%,-0.0199,1.96,0.92,66422,20785,3635,177,13846,47521,34808,51333,31614,15089,"(CONTRACTS OF 100,000 CANADIAN DOLLARS)"
06/04/2004,CAD,1.309,-0.21%,-0.0021,1.99,0.96,86421,44219,2354,67,11327,71326,55613,73747,30808,12674,"(CONTRACTS OF 100,000 CANADIAN DOLLARS)"
30/03/2004,CAD,1.3063,1.95%,0.0197,1.99,0.99,76113,35066,2051,85,11716,61888,46867,64024,29246,12089,"(CONTRACTS OF 100,000 CANADIAN DOLLARS)"
23/03/2004,CAD,1.3323,0.00%,0,2.04,1.03,48702,10562,3462,228,11945,31507,22735,35197,25967,13505,"(CONTRACTS OF 100,000 CANADIAN DOLLARS)"
16/03/2004,CAD,1.3323,-0.62%,-0.0062,2.09,1.07,71603,9820,6078,287,33705,49404,43812,55769,27791,15834,"(CONTRACTS OF 100,000 CANADIAN DOLLARS)"
09/03/2004,CAD,1.3241,1.33%,0.0134,2.12,1.13,72882,11605,8781,797,29441,47098,41843,56676,31039,16206,"(CONTRACTS OF 100,000 CANADIAN DOLLARS)"
02/03/2004,CAD,1.342,-1.00%,-0.01,2.2,1.19,65508,5834,15249,220,31777,33766,37831,49235,27677,16273,"(CONTRACTS OF 100,000 CANADIAN DOLLARS)"
24/02/2004,CAD,1.3287,-1.43%,-0.0142,2.22,1.21,62648,6769,13545,645,26795,32930,34209,47120,28439,15528,"(CONTRACTS OF 100,000 CANADIAN DOLLARS)"
17/02/2004,CAD,1.31,1.53%,0.0154,2.23,1.23,61898,8385,8758,521,22919,39522,31825,48801,30073,13097,"(CONTRACTS OF 100,000 CANADIAN DOLLARS)"
10/02/2004,CAD,1.3303,0.53%,0.0053,2.29,1.25,66688,7968,12402,120,29483,39509,37571,52031,29117,14657,"(CONTRACTS OF 100,000 CANADIAN DOLLARS)"
03/02/2004,CAD,1.3374,-2.47%,-0.0244,2.34,1.3,63329,7835,11687,95,26927,37883,34857,49665,28472,13664,"(CONTRACTS OF 100,000 CANADIAN DOLLARS)"
27/01/2004,CAD,1.3052,-1.10%,-0.0109,2.29,1.26,65919,16478,2769,19,18303,51712,34800,54500,31119,11419,"(CONTRACTS OF 100,000 CANADIAN DOLLARS)"
20/01/2004,CAD,1.291,-1.60%,-0.0158,2.41,1.37,76063,25232,1288,266,15120,62636,40618,64190,35445,11873,"(CONTRACTS OF 100,000 CANADIAN DOLLARS)"
13/01/2004,CAD,1.2707,1.15%,0.0116,2.47,1.43,89905,39658,2089,1,12964,76580,52623,78670,37282,11235,"(CONTRACTS OF 100,000 CANADIAN DOLLARS)"
06/01/2004,CAD,1.2855,1.91%,0.0193,2.56,1.5,73435,29498,2286,128,11732,58933,41358,61347,32077,12088,"(CONTRACTS OF 100,000 CANADIAN DOLLARS)"
30/12/2003,CAD,1.3105,1.51%,0.0152,2.65,1.57,66536,22336,3377,32,13092,50732,35460,54141,31076,12395,"(CONTRACTS OF 100,000 CANADIAN DOLLARS)"
22/12/2003,CAD,1.3306,-0.26%,-0.0026,2.63,1.55,62750,13535,4872,25,17501,45058,31061,49955,31689,12795,"(CONTRACTS OF 100,000 CANADIAN DOLLARS)"
16/12/2003,CAD,1.3271,-1.58%,-0.0156,2.63,1.54,81898,17627,1029,45,29274,65651,46946,66725,34952,15173,"(CONTRACTS OF 100,000 CANADIAN DOLLARS)"
09/12/2003,CAD,1.3065,-0.72%,-0.0072,2.71,1.64,87364,27407,320,1220,20703,70552,49330,72092,38034,15272,"(CONTRACTS OF 100,000 CANADIAN DOLLARS)"
02/12/2003,CAD,1.2971,0.89%,0.009,2.67,1.6,82914,31155,487,204,14709,69174,46068,69865,36846,13049,"(CONTRACTS OF 100,000 CANADIAN DOLLARS)"
25/11/2003,CAD,1.3088,-0.86%,-0.0086,2.65,1.61,79162,26518,641,367,14430,64579,41315,65587,37847,13575,"(CONTRACTS OF 100,000 CANADIAN DOLLARS)"
18/11/2003,CAD,1.2976,1.01%,0.0102,2.72,1.65,86715,34048,572,108,13996,73250,48152,73930,38563,12785,"(CONTRACTS OF 100,000 CANADIAN DOLLARS)"
11/11/2003,CAD,1.3109,1.31%,0.0132,2.73,1.67,80154,30192,487,100,14012,68526,44304,69113,35850,11041,"(CONTRACTS OF 100,000 CANADIAN DOLLARS)"
04/11/2003,CAD,1.3283,-1.43%,-0.0142,2.67,1.62,78303,29207,487,455,14375,65547,44037,66489,34266,11814,"(CONTRACTS OF 100,000 CANADIAN DOLLARS)"
28/10/2003,CAD,1.3096,0.51%,0.0051,2.63,1.57,84034,34353,1482,76,12882,70656,47311,72214,36723,11820,"(CONTRACTS OF 100,000 CANADIAN DOLLARS)"
21/10/2003,CAD,1.3163,0.58%,0.0058,2.66,1.61,80185,29847,442,8,11987,67505,41842,67955,38343,12230,"(CONTRACTS OF 100,000 CANADIAN DOLLARS)"
14/10/2003,CAD,1.324,0.49%,0.0049,2.6,1.56,80019,30697,843,52,12710,66469,43459,67364,36560,12655,"(CONTRACTS OF 100,000 CANADIAN DOLLARS)"
07/10/2003,CAD,1.3305,1.61%,0.0163,2.57,1.54,76303,31011,411,0,9950,61938,40961,62349,35342,13954,"(CONTRACTS OF 100,000 CANADIAN DOLLARS)"
30/09/2003,CAD,1.3523,0.32%,0.0032,2.6,1.57,69358,24828,1741,0,11118,57389,35946,59130,33412,10228,"(CONTRACTS OF 100,000 CANADIAN DOLLARS)"
23/09/2003,CAD,1.3566,0.86%,0.0086,2.54,1.51,66514,23454,1147,0,10188,54750,33642,55897,32872,10617,"(CONTRACTS OF 100,000 CANADIAN DOLLARS)"
16/09/2003,CAD,1.3683,-0.13%,-0.0013,2.63,1.6,81631,20282,150,350,22913,68008,43545,68508,38086,13123,"(CONTRACTS OF 100,000 CANADIAN DOLLARS)"
09/09/2003,CAD,1.3665,1.94%,0.0196,2.65,1.61,78757,19420,0,0,27906,65004,47326,65004,31431,13753,"(CONTRACTS OF 100,000 CANADIAN DOLLARS)"
02/09/2003,CAD,1.3936,0.04%,0.0004,2.7,1.65,64314,12384,119,71,24231,50743,36686,50933,27628,13381,"(CONTRACTS OF 100,000 CANADIAN DOLLARS)"
26/08/2003,CAD,1.3941,0.09%,0.0009,2.69,1.68,62024,9662,113,302,26626,47642,36590,48057,25434,13967,"(CONTRACTS OF 100,000 CANADIAN DOLLARS)"
19/08/2003,CAD,1.3954,-0.79%,-0.0078,2.73,1.71,61784,10444,473,217,25024,49479,35685,50169,26099,11615,"(CONTRACTS OF 100,000 CANADIAN DOLLARS)"
12/08/2003,CAD,1.3845,0.97%,0.0097,2.78,1.75,66366,13743,697,84,23835,52289,37662,53070,28704,13296,"(CONTRACTS OF 100,000 CANADIAN DOLLARS)"
05/08/2003,CAD,1.398,-0.81%,-0.008,2.83,1.81,62515,9585,1290,397,26813,48749,36795,50436,25720,12079,"(CONTRACTS OF 100,000 CANADIAN DOLLARS)"
29/07/2003,CAD,1.3868,2.01%,0.0203,2.8,1.77,62645,10028,594,888,27302,48809,38218,50291,24427,12354,"(CONTRACTS OF 100,000 CANADIAN DOLLARS)"
22/07/2003,CAD,1.4153,-1.75%,-0.0173,2.76,1.75,66155,9352,1086,801,29486,46905,39639,48792,26516,17363,"(CONTRACTS OF 100,000 CANADIAN DOLLARS)"
15/07/2003,CAD,1.391,-2.02%,-0.02,2.91,1.91,69818,12118,2782,817,27697,52742,40632,56341,29186,13477,"(CONTRACTS OF 100,000 CANADIAN DOLLARS)"
08/07/2003,CAD,1.3635,-0.84%,-0.0083,3.04,2.03,74235,17984,61,906,25817,55425,44707,56392,29528,17843,"(CONTRACTS OF 100,000 CANADIAN DOLLARS)"
01/07/2003,CAD,1.3522,0.56%,0.0056,3.05,2.04,75746,18022,1241,167,25862,60872,44051,62280,31695,13466,"(CONTRACTS OF 100,000 CANADIAN DOLLARS)"
24/06/2003,CAD,1.3598,-1.75%,-0.0174,3,2.12,72542,16599,820,128,25013,58088,41740,59036,30802,13506,"(CONTRACTS OF 100,000 CANADIAN DOLLARS)"
17/06/2003,CAD,1.3364,1.96%,0.0198,3.12,2.19,92878,19963,1509,151,33231,78406,53345,80066,39533,12812,"(CONTRACTS OF 100,000 CANADIAN DOLLARS)"
10/06/2003,CAD,1.3631,0.08%,0.0008,3.13,2.09,95778,20614,2934,151,36283,75630,57048,78715,38730,17063,"(CONTRACTS OF 100,000 CANADIAN DOLLARS)"
03/06/2003,CAD,1.3642,0.91%,0.0091,3.14,1.97,94481,21775,3413,799,33826,77335,56400,81547,38081,12934,"(CONTRACTS OF 100,000 CANADIAN DOLLARS)"
27/05/2003,CAD,1.3767,-2.20%,-0.0217,3.12,1.92,93169,22461,2514,1558,32151,77215,56170,81287,36999,11882,"(CONTRACTS OF 100,000 CANADIAN DOLLARS)"
20/05/2003,CAD,1.3471,2.76%,0.028,3.2,2.08,95663,26085,525,669,28284,80851,55038,82045,40625,13618,"(CONTRACTS OF 100,000 CANADIAN DOLLARS)"
13/05/2003,CAD,1.3853,0.47%,0.0048,3.23,2.05,98743,31618,728,880,26743,84145,59241,85753,39502,12990,"(CONTRACTS OF 100,000 CANADIAN DOLLARS)"
06/05/2003,CAD,1.3919,3.41%,0.0347,3.25,2.11,97802,33702,945,0,24192,84578,57894,85523,39908,12279,"(CONTRACTS OF 100,000 CANADIAN DOLLARS)"
29/04/2003,CAD,1.441,0.38%,0.0038,3.22,2,102455,36374,938,0,25275,89385,61649,90323,40806,12132,"(CONTRACTS OF 100,000 CANADIAN DOLLARS)"
22/04/2003,CAD,1.4465,0.14%,0.0014,3.2,1.99,97984,31288,200,543,24667,85425,56498,86168,41486,11816,"(CONTRACTS OF 100,000 CANADIAN DOLLARS)"
15/04/2003,CAD,1.4485,1.29%,0.013,3.27,2.04,97003,33509,200,589,22578,85274,56676,86063,40327,10940,"(CONTRACTS OF 100,000 CANADIAN DOLLARS)"
08/04/2003,CAD,1.4674,0.41%,0.0041,3.09,1.93,94969,33003,200,0,22399,82123,55402,82323,39567,12646,"(CONTRACTS OF 100,000 CANADIAN DOLLARS)"
01/04/2003,CAD,1.4735,0.13%,0.0013,3.11,1.97,94115,33961,772,454,20612,80729,55027,81955,39088,12160,"(CONTRACTS OF 100,000 CANADIAN DOLLARS)"
25/03/2003,CAD,1.4754,-0.14%,-0.0014,3.11,1.91,93264,34508,300,0,21319,81402,55827,81702,37437,11562,"(CONTRACTS OF 100,000 CANADIAN DOLLARS)"
18/03/2003,CAD,1.4734,-0.14%,-0.0014,3.1,1.93,121951,42676,0,0,34433,110559,77109,110559,44842,11392,"(CONTRACTS OF 100,000 CANADIAN DOLLARS)"
11/03/2003,CAD,1.4714,0.46%,0.0046,3.03,1.92,121735,41764,0,0,31933,108215,73697,108215,48038,13520,"(CONTRACTS OF 100,000 CANADIAN DOLLARS)"
04/03/2003,CAD,1.4782,1.00%,0.0101,2.94,1.71,112974,42784,320,0,22082,101892,64866,102212,48108,10762,"(CONTRACTS OF 100,000 CANADIAN DOLLARS)"
25/02/2003,CAD,1.4932,1.56%,0.0157,2.85,1.62,109750,41929,320,901,22655,97738,65485,98959,44265,10791,"(CONTRACTS OF 100,000 CANADIAN DOLLARS)"
18/02/2003,CAD,1.5168,0.82%,0.0083,2.78,1.53,105250,43606,200,441,18298,92224,62345,92865,42905,12385,"(CONTRACTS OF 100,000 CANADIAN DOLLARS)"
11/02/2003,CAD,1.5294,-0.97%,-0.0097,2.77,1.51,101272,42852,30,711,17215,90191,60778,90932,40494,10340,"(CONTRACTS OF 100,000 CANADIAN DOLLARS)"
04/02/2003,CAD,1.5147,0.83%,0.0083,2.83,1.59,102651,43347,200,93,16972,90878,60412,91171,42239,11480,"(CONTRACTS OF 100,000 CANADIAN DOLLARS)"
28/01/2003,CAD,1.5274,0.31%,0.0031,2.8,1.56,97544,39185,937,0,17911,86664,57096,87601,40448,9943,"(CONTRACTS OF 100,000 CANADIAN DOLLARS)"
21/01/2003,CAD,1.5322,0.53%,0.0053,2.78,1.54,91593,32585,600,2250,16179,78778,51014,81628,40579,9965,"(CONTRACTS OF 100,000 CANADIAN DOLLARS)"
14/01/2003,CAD,1.5403,1.43%,0.0144,2.73,1.45,81532,25482,500,1050,15656,69949,42188,71499,39344,10033,"(CONTRACTS OF 100,000 CANADIAN DOLLARS)"
07/01/2003,CAD,1.5626,0.91%,0.0092,2.75,1.46,61623,13131,0,480,14304,50139,27915,50619,33708,11004,"(CONTRACTS OF 100,000 CANADIAN DOLLARS)"
31/12/2002,CAD,1.577,-1.66%,-0.0164,2.7,1.42,62742,14855,3336,30,13357,48398,28242,51764,34500,10978,"(CONTRACTS OF 100,000 CANADIAN DOLLARS)"
23/12/2002,CAD,1.5513,-0.19%,-0.0019,2.74,1.44,68035,23062,0,5,10785,59300,33852,59305,34183,8730,"(CONTRACTS OF 100,000 CANADIAN DOLLARS)"
17/12/2002,CAD,1.5483,0.75%,0.0075,2.73,1.41,89152,24101,488,13,30248,75520,54362,76021,34790,13131,"(CONTRACTS OF 100,000 CANADIAN DOLLARS)"
10/12/2002,CAD,1.56,-0.20%,-0.002,2.73,1.44,77910,18682,0,13,26492,62984,45187,62997,32723,14913,"(CONTRACTS OF 100,000 CANADIAN DOLLARS)"
03/12/2002,CAD,1.5569,1.17%,0.0117,2.75,1.41,64722,17276,634,300,16671,50563,34247,51497,30475,13225,"(CONTRACTS OF 100,000 CANADIAN DOLLARS)"
26/11/2002,CAD,1.5753,0.53%,0.0053,2.75,1.45,59002,8708,4406,0,21316,40609,30024,45015,28978,13987,"(CONTRACTS OF 100,000 CANADIAN DOLLARS)"
19/11/2002,CAD,1.5837,-0.37%,-0.0037,2.75,1.41,61051,10173,5683,857,20579,40902,31609,47442,29442,13609,"(CONTRACTS OF 100,000 CANADIAN DOLLARS)"
12/11/2002,CAD,1.5778,-1.32%,-0.0131,2.72,1.38,59832,13449,1724,587,15622,46667,29658,48978,30174,10854,"(CONTRACTS OF 100,000 CANADIAN DOLLARS)"
05/11/2002,CAD,1.5572,0.38%,0.0038,2.75,1.49,61231,17085,1469,0,12749,48503,29834,49972,31397,11259,"(CONTRACTS OF 100,000 CANADIAN DOLLARS)"
29/10/2002,CAD,1.5631,0.28%,0.0028,2.78,1.18,57794,14787,2202,321,12775,43129,27883,45652,29911,12142,"(CONTRACTS OF 100,000 CANADIAN DOLLARS)"
22/10/2002,CAD,1.5675,1.23%,0.0124,2.77,1.05,56278,9755,2189,0,16873,39931,26628,42120,29650,14158,"(CONTRACTS OF 100,000 CANADIAN DOLLARS)"
15/10/2002,CAD,1.587,0.60%,0.006,2.82,1.08,57220,7633,8043,0,20142,32705,27775,40748,29445,16472,"(CONTRACTS OF 100,000 CANADIAN DOLLARS)"
08/10/2002,CAD,1.5965,-0.95%,-0.0094,2.78,1.11,55966,7560,7507,0,19501,32263,27061,39770,28905,16196,"(CONTRACTS OF 100,000 CANADIAN DOLLARS)"
01/10/2002,CAD,1.5815,0.30%,0.003,2.79,1.13,52448,6000,6414,0,17815,31782,23815,38196,28633,14252,"(CONTRACTS OF 100,000 CANADIAN DOLLARS)"
24/09/2002,CAD,1.5862,-0.32%,-0.0032,2.82,1.1,51972,6520,5908,0,16994,31216,23514,37124,28458,14848,"(CONTRACTS OF 100,000 CANADIAN DOLLARS)"
17/09/2002,CAD,1.5812,-0.59%,-0.0058,2.84,1.11,73191,8942,6768,0,32387,52521,41329,59289,31862,13902,"(CONTRACTS OF 100,000 CANADIAN DOLLARS)"
10/09/2002,CAD,1.572,-1.24%,-0.0123,2.81,1.08,75560,14014,3411,771,29107,58378,43892,62560,31668,13000,"(CONTRACTS OF 100,000 CANADIAN DOLLARS)"
03/09/2002,CAD,1.5528,0.05%,0.0005,2.89,1.17,69959,13983,3463,0,29139,54824,43122,58287,26837,11672,"(CONTRACTS OF 100,000 CANADIAN DOLLARS)"
27/08/2002,CAD,1.5535,0.89%,0.009,2.91,1.18,61302,5905,3138,0,29687,45182,35592,48320,25710,12982,"(CONTRACTS OF 100,000 CANADIAN DOLLARS)"
20/08/2002,CAD,1.5675,-0.19%,-0.0019,2.79,1.1,63401,5373,4816,0,32087,45324,37460,50140,25941,13261,"(CONTRACTS OF 100,000 CANADIAN DOLLARS)"
13/08/2002,CAD,1.5645,1.27%,0.0128,2.75,1.05,62556,5236,4175,0,31499,45611,36735,49786,25821,12770,"(CONTRACTS OF 100,000 CANADIAN DOLLARS)"
06/08/2002,CAD,1.5846,-0.63%,-0.0063,2.67,1.01,65956,5739,4505,0,31628,48483,37367,52988,28589,12968,"(CONTRACTS OF 100,000 CANADIAN DOLLARS)"
30/07/2002,CAD,1.5747,0.48%,0.0048,2.74,1.01,63134,8821,4616,0,24756,46605,33577,51221,29557,11913,"(CONTRACTS OF 100,000 CANADIAN DOLLARS)"
23/07/2002,CAD,1.5823,-2.91%,-0.0287,2.68,0.94,70325,14095,4989,0,22862,53658,36957,58647,33368,11678,"(CONTRACTS OF 100,000 CANADIAN DOLLARS)"
16/07/2002,CAD,1.5375,-1.71%,-0.0169,2.71,0.93,77868,19536,3314,0,19631,63921,39167,67235,38701,10633,"(CONTRACTS OF 100,000 CANADIAN DOLLARS)"
09/07/2002,CAD,1.5117,0.95%,0.0095,2.8,1.05,81078,25180,2864,0,17773,68608,42953,71472,38125,9606,"(CONTRACTS OF 100,000 CANADIAN DOLLARS)"
02/07/2002,CAD,1.5262,-0.75%,-0.0075,2.78,1.01,78330,25139,1727,0,17102,67095,42241,68822,36089,9508,"(CONTRACTS OF 100,000 CANADIAN DOLLARS)"
25/06/2002,CAD,1.5148,1.99%,0.0201,2.75,0.93,76098,20756,2581,0,18607,63394,39363,65975,36735,10123,"(CONTRACTS OF 100,000 CANADIAN DOLLARS)"
18/06/2002,CAD,1.5456,-0.67%,-0.0067,2.65,0.87,94694,22162,3217,0,33058,79135,55220,82352,39474,12342,"(CONTRACTS OF 100,000 CANADIAN DOLLARS)"
11/06/2002,CAD,1.5353,-0.27%,-0.0027,2.64,0.87,95310,24689,0,0,32189,79317,56878,79317,38432,15993,"(CONTRACTS OF 100,000 CANADIAN DOLLARS)"
04/06/2002,CAD,1.5312,-0.05%,-0.0005,2.63,0.84,88429,27776,4498,235,24137,71402,52148,76135,36281,12294,"(CONTRACTS OF 100,000 CANADIAN DOLLARS)"
28/05/2002,CAD,1.5305,0.38%,0.0038,2.58,0.79,87172,27114,8909,483,23600,65600,51197,74992,35975,12180,"(CONTRACTS OF 100,000 CANADIAN DOLLARS)"
21/05/2002,CAD,1.5364,1.37%,0.0138,2.58,0.77,83236,23552,8351,528,24057,60995,48137,69874,35099,13362,"(CONTRACTS OF 100,000 CANADIAN DOLLARS)"
14/05/2002,CAD,1.5578,0.56%,0.0056,2.6,0.81,80626,22304,11781,331,25845,57134,48480,69246,32146,11380,"(CONTRACTS OF 100,000 CANADIAN DOLLARS)"
07/05/2002,CAD,1.5666,0.04%,0.0004,2.41,0.62,77436,19596,13414,0,25890,52398,45486,65812,31950,11624,"(CONTRACTS OF 100,000 CANADIAN DOLLARS)"
30/04/2002,CAD,1.5673,0.32%,0.0032,2.3,0.44,71236,13840,11533,240,26606,45707,40686,57480,30550,13756,"(CONTRACTS OF 100,000 CANADIAN DOLLARS)"
23/04/2002,CAD,1.5724,0.59%,0.0059,2.36,0.54,69168,10765,11234,240,29214,43568,40219,55042,28949,14126,"(CONTRACTS OF 100,000 CANADIAN DOLLARS)"
16/04/2002,CAD,1.5817,0.85%,0.0086,2.29,0.46,64020,5992,14814,23,31032,33660,37047,48497,26973,15523,"(CONTRACTS OF 100,000 CANADIAN DOLLARS)"
09/04/2002,CAD,1.5953,-0.16%,-0.0016,2.34,0.46,71824,6269,27031,27,40907,27860,47203,54918,24621,16906,"(CONTRACTS OF 100,000 CANADIAN DOLLARS)"
02/04/2002,CAD,1.5928,-0.07%,-0.0007,2.29,0.37,65664,6936,19422,27,31650,31749,38613,51198,27051,14466,"(CONTRACTS OF 100,000 CANADIAN DOLLARS)"
26/03/2002,CAD,1.5917,-0.49%,-0.0048,2.27,0.32,62741,8954,13510,27,27805,32909,36786,46446,25955,16295,"(CONTRACTS OF 100,000 CANADIAN DOLLARS)"
19/03/2002,CAD,1.584,0.06%,0.0006,2.17,0.24,76366,11431,13722,555,36472,44232,48458,58509,27908,17857,"(CONTRACTS OF 100,000 CANADIAN DOLLARS)"
12/03/2002,CAD,1.585,0.16%,0.0016,2.15,0.23,76124,11215,13315,565,35214,41851,46994,55731,29130,20393,"(CONTRACTS OF 100,000 CANADIAN DOLLARS)"
05/03/2002,CAD,1.5876,1.33%,0.0134,2.02,0.12,71722,8231,18325,437,35304,29626,43972,48388,27750,23334,"(CONTRACTS OF 100,000 CANADIAN DOLLARS)"
26/02/2002,CAD,1.609,-1.19%,-0.0119,2.02,0.19,80851,7508,27468,947,44433,28193,52888,56608,27963,24243,"(CONTRACTS OF 100,000 CANADIAN DOLLARS)"
19/02/2002,CAD,1.59,0.07%,0.0007,1.96,0.15,71389,9420,18758,599,37235,32605,47254,51962,24135,19427,"(CONTRACTS OF 100,000 CANADIAN DOLLARS)"
12/02/2002,CAD,1.5911,0.33%,0.0033,1.98,0.17,70779,6825,20421,454,38240,29774,45519,50649,25260,20130,"(CONTRACTS OF 100,000 CANADIAN DOLLARS)"
05/02/2002,CAD,1.5963,-0.21%,-0.0021,1.98,0.2,68040,6294,21720,10,38310,26222,44614,47952,23426,20088,"(CONTRACTS OF 100,000 CANADIAN DOLLARS)"
29/01/2002,CAD,1.593,0.92%,0.0092,1.95,0.2,72933,5473,22637,16,41773,23837,47262,46490,25671,26443,"(CONTRACTS OF 100,000 CANADIAN DOLLARS)"
22/01/2002,CAD,1.6078,-1.20%,-0.012,1.96,0.17,76458,6459,28504,19,43740,20876,50218,49399,26240,27059,"(CONTRACTS OF 100,000 CANADIAN DOLLARS)"
15/01/2002,CAD,1.5887,0.43%,0.0043,1.84,0.12,67456,5816,21261,0,33848,21095,39664,42356,27792,25100,"(CONTRACTS OF 100,000 CANADIAN DOLLARS)"
08/01/2002,CAD,1.5955,-0.33%,-0.0033,1.93,0.3,61485,4934,20267,8,31607,16877,36549,37152,24936,24333,"(CONTRACTS OF 100,000 CANADIAN DOLLARS)"
28/12/2001,CAD,1.5902,-0.33%,-0.0033,1.96,0.17,59460,4463,19064,0,30066,19143,34529,38207,24931,21253,"(CONTRACTS OF 100,000 CANADIAN DOLLARS)"
21/12/2001,CAD,1.5849,-0.72%,-0.0072,2,0.2,51055,5691,11782,0,23218,20915,28909,32697,22146,18358,"(CONTRACTS OF 100,000 CANADIAN DOLLARS)"
18/12/2001,CAD,1.5735,-0.01%,-0.0001,2.05,0.3,75039,6470,11370,0,41276,44599,47746,55969,27293,19070,"(CONTRACTS OF 100,000 CANADIAN DOLLARS)"
11/12/2001,CAD,1.5733,-0.15%,-0.0015,2.05,0.19,77469,4954,12748,650,44464,38768,50068,52166,27401,25303,"(CONTRACTS OF 100,000 CANADIAN DOLLARS)"
04/12/2001,CAD,1.571,1.37%,0.0138,2.1,0.36,74823,5272,13242,44,43125,38386,48441,51672,26382,23151,"(CONTRACTS OF 100,000 CANADIAN DOLLARS)"
27/11/2001,CAD,1.5929,0.12%,0.0012,2.25,0.34,87310,3288,29960,425,59840,31474,63553,61859,23757,25451,"(CONTRACTS OF 100,000 CANADIAN DOLLARS)"
20/11/2001,CAD,1.5948,-0.07%,-0.0007,2.27,0.28,83231,3288,28663,0,55412,29289,58700,57952,24531,25279,"(CONTRACTS OF 100,000 CANADIAN DOLLARS)"
13/11/2001,CAD,1.5937,-0.10%,-0.001,2.12,0.14,83277,3353,31442,10,55415,23609,58778,55061,24499,28216,"(CONTRACTS OF 100,000 CANADIAN DOLLARS)"
06/11/2001,CAD,1.5921,-0.89%,-0.0089,2.3,0.37,78392,3330,29762,15,50904,22518,54249,52295,24143,26097,"(CONTRACTS OF 100,000 CANADIAN DOLLARS)"
30/10/2001,CAD,1.578,-0.39%,-0.0039,2.42,0.5,72414,2629,23202,0,44879,25031,47508,48233,24906,24181,"(CONTRACTS OF 100,000 CANADIAN DOLLARS)"
23/10/2001,CAD,1.5718,-0.42%,-0.0042,2.7,0.59,70752,3210,23014,360,43143,24768,46713,48142,24039,22610,"(CONTRACTS OF 100,000 CANADIAN DOLLARS)"
16/10/2001,CAD,1.5652,0.00%,0,2.95,0.78,68069,5300,17918,5,38938,28970,44243,46893,23826,21176,"(CONTRACTS OF 100,000 CANADIAN DOLLARS)"
09/10/2001,CAD,1.5652,0.13%,0.0013,3,0.71,72186,4092,24381,335,44940,24991,49367,49707,22819,22479,"(CONTRACTS OF 100,000 CANADIAN DOLLARS)"
02/10/2001,CAD,1.5672,0.18%,0.0018,3.11,0.73,73001,3386,33725,0,46287,17679,49673,51404,23328,21597,"(CONTRACTS OF 100,000 CANADIAN DOLLARS)"
25/09/2001,CAD,1.57,0.13%,0.0013,3.1,0.69,67827,3279,31216,0,43040,14788,46319,46004,21508,21823,"(CONTRACTS OF 100,000 CANADIAN DOLLARS)"
18/09/2001,CAD,1.572,-0.50%,-0.005,3.4,0.9,83693,2896,29474,322,57437,29084,60655,58880,23038,24813,"(CONTRACTS OF 100,000 CANADIAN DOLLARS)"
10/09/2001,CAD,1.5642,-0.38%,-0.0038,3.65,1.15,79523,3124,28391,616,48103,23650,51843,52657,27680,26866,"(CONTRACTS OF 100,000 CANADIAN DOLLARS)"
04/09/2001,CAD,1.5583,-1.27%,-0.0126,3.84,0.81,65580,3533,19060,51,38129,23387,41713,42498,23867,23082,"(CONTRACTS OF 100,000 CANADIAN DOLLARS)"
28/08/2001,CAD,1.5388,0.59%,0.0059,3.85,0.39,58016,3946,10821,15,31358,31101,35319,41937,22697,16079,"(CONTRACTS OF 100,000 CANADIAN DOLLARS)"
21/08/2001,CAD,1.5479,-0.83%,-0.0083,3.91,0.53,57084,3187,10321,15,40267,40692,43469,51028,13615,6056,"(CONTRACTS OF 100,000 CANADIAN DOLLARS)"
14/08/2001,CAD,1.5351,0.00%,0,3.98,0.57,51988,4362,6013,0,31870,39694,36232,45707,15756,6281,"(CONTRACTS OF 100,000 CANADIAN DOLLARS)"
07/08/2001,CAD,1.5351,-0.14%,-0.0014,4.06,0.59,52698,4322,5882,0,24705,33150,29027,39032,23671,13666,"(CONTRACTS OF 100,000 CANADIAN DOLLARS)"
31/07/2001,CAD,1.533,0.43%,0.0043,4.02,0.5,51491,4673,6048,420,24251,31680,29344,38148,22147,13343,"(CONTRACTS OF 100,000 CANADIAN DOLLARS)"
24/07/2001,CAD,1.5396,-0.11%,-0.0011,4.18,0.66,57116,3957,16148,784,29434,27786,34175,44718,22941,12398,"(CONTRACTS OF 100,000 CANADIAN DOLLARS)"
17/07/2001,CAD,1.5379,-1.20%,-0.012,4.2,0.57,54950,5565,9728,284,24551,32204,30400,42216,24550,12734,"(CONTRACTS OF 100,000 CANADIAN DOLLARS)"
10/07/2001,CAD,1.5196,-0.60%,-0.0059,4.31,0.64,53021,7197,5725,166,18523,35175,25886,41066,27135,11955,"(CONTRACTS OF 100,000 CANADIAN DOLLARS)"
03/07/2001,CAD,1.5106,0.40%,0.004,4.35,0.73,53420,7625,5501,166,18920,35354,26711,41021,26709,12399,"(CONTRACTS OF 100,000 CANADIAN DOLLARS)"
26/06/2001,CAD,1.5167,1.11%,0.0111,4.3,0.57,53314,7771,11178,299,17216,31166,25286,42643,28028,10671,"(CONTRACTS OF 100,000 CANADIAN DOLLARS)"
19/06/2001,CAD,1.5337,-0.65%,-0.0065,4.33,0.63,69704,6765,11575,299,33022,42577,40086,54451,29618,15253,"(CONTRACTS OF 100,000 CANADIAN DOLLARS)"
12/06/2001,CAD,1.5238,0.46%,0.0046,4.29,0.65,70123,7532,13041,342,34217,39450,42091,52833,28032,17290,"(CONTRACTS OF 100,000 CANADIAN DOLLARS)"
05/06/2001,CAD,1.5308,0.34%,0.0034,4.4,0.63,64530,7287,18816,680,31609,28994,39576,48490,24954,16040,"(CONTRACTS OF 100,000 CANADIAN DOLLARS)"
29/05/2001,CAD,1.536,0.26%,0.0026,4.35,0.53,65466,4303,18345,13,38560,29761,42876,48119,22590,17347,"(CONTRACTS OF 100,000 CANADIAN DOLLARS)"
22/05/2001,CAD,1.54,0.34%,0.0034,4.4,0.48,64565,4986,16488,0,35337,32166,40323,48654,24242,15911,"(CONTRACTS OF 100,000 CANADIAN DOLLARS)"
15/05/2001,CAD,1.5452,-0.23%,-0.0023,4.3,0.36,65681,2979,17833,0,39611,31863,42590,49696,23091,15985,"(CONTRACTS OF 100,000 CANADIAN DOLLARS)"
08/05/2001,CAD,1.5417,-0.62%,-0.0062,4.33,0.42,65893,3986,17120,27,37072,32003,41085,49150,24808,16743,"(CONTRACTS OF 100,000 CANADIAN DOLLARS)"
01/05/2001,CAD,1.5322,0.84%,0.0084,4.37,0.38,63144,4485,16641,27,37975,29663,42487,46331,20657,16813,"(CONTRACTS OF 100,000 CANADIAN DOLLARS)"
24/04/2001,CAD,1.5452,1.21%,0.0122,4.35,0.17,64298,3543,17060,0,41293,28881,44836,45941,19462,18357,"(CONTRACTS OF 100,000 CANADIAN DOLLARS)"
17/04/2001,CAD,1.5642,-0.57%,-0.0057,4.56,0.35,63369,3101,18703,311,40347,23997,43759,43011,19610,20358,"(CONTRACTS OF 100,000 CANADIAN DOLLARS)"
10/04/2001,CAD,1.5553,1.33%,0.0133,4.49,0.24,64143,4069,19091,310,39717,24036,44096,43437,20047,20706,"(CONTRACTS OF 100,000 CANADIAN DOLLARS)"
03/04/2001,CAD,1.5762,-0.56%,-0.0056,4.6,-0.12,66276,3959,23323,1000,43111,22109,48070,46432,18206,19844,"(CONTRACTS OF 100,000 CANADIAN DOLLARS)"
27/03/2001,CAD,1.5674,-0.17%,-0.0017,4.5313,-0.17,65818,3470,24502,1048,43010,19990,47528,45540,18290,20278,"(CONTRACTS OF 100,000 CANADIAN DOLLARS)"
20/03/2001,CAD,1.5648,-1.38%,-0.0137,4.55,-0.2,78051,9314,23988,179,49631,33561,59124,57728,18927,20323,"(CONTRACTS OF 100,000 CANADIAN DOLLARS)"
13/03/2001,CAD,1.5435,-0.41%,-0.0041,4.7,-0.12,80110,10414,23833,554,46287,34822,57255,59209,22855,20901,"(CONTRACTS OF 100,000 CANADIAN DOLLARS)"
06/03/2001,CAD,1.5372,-0.50%,-0.005,4.78,0.02,70550,8966,22446,15,40714,26985,49695,49446,20855,21104,"(CONTRACTS OF 100,000 CANADIAN DOLLARS)"
27/02/2001,CAD,1.5295,0.64%,0.0065,5.03,0.03,69634,7853,20802,1087,41559,30065,50499,51954,19135,17680,"(CONTRACTS OF 100,000 CANADIAN DOLLARS)"
20/02/2001,CAD,1.5394,-1.20%,-0.0119,5.12,0.1,61308,8476,12774,39,34033,31553,42548,44366,18760,16942,"(CONTRACTS OF 100,000 CANADIAN DOLLARS)"
13/02/2001,CAD,1.5212,-0.69%,-0.0069,5.15,0.02,57201,9971,9946,367,27843,30848,38181,41161,19020,16040,"(CONTRACTS OF 100,000 CANADIAN DOLLARS)"
06/02/2001,CAD,1.5108,-0.60%,-0.006,5.2,-0.09,51675,10988,2336,367,19150,36723,30505,39426,21170,12249,"(CONTRACTS OF 100,000 CANADIAN DOLLARS)"
30/01/2001,CAD,1.5018,0.57%,0.0057,5.27,-0.06,50284,10381,3157,357,20180,35659,30918,39173,19366,11111,"(CONTRACTS OF 100,000 CANADIAN DOLLARS)"
23/01/2001,CAD,1.5104,-0.29%,-0.0029,5.34,0,52651,12107,2190,357,20356,36988,32820,39535,19831,13116,"(CONTRACTS OF 100,000 CANADIAN DOLLARS)"
16/01/2001,CAD,1.5061,-0.85%,-0.0085,5.3,-0.2,57391,11507,7533,359,23691,38416,35557,46308,21834,11083,"(CONTRACTS OF 100,000 CANADIAN DOLLARS)"
09/01/2001,CAD,1.4934,-0.13%,-0.0013,5.32,-0.21,57409,9894,7873,299,23062,38032,33255,46204,24154,11205,"(CONTRACTS OF 100,000 CANADIAN DOLLARS)"
02/01/2001,CAD,1.4914,1.21%,0.0121,5.53,-0.13,52655,5119,8942,299,23434,31986,28852,41227,23803,11428,"(CONTRACTS OF 100,000 CANADIAN DOLLARS)"
26/12/2000,CAD,1.5096,0.89%,0.009,5.73,-0.74,55410,3950,15480,0,29371,26408,33321,41888,22089,13522,"(CONTRACTS OF 100,000 CANADIAN DOLLARS)"
19/12/2000,CAD,1.5232,0.31%,0.0031,5.65,-0.53,69859,3637,17283,0,43058,34894,46695,52177,23164,17682,"(CONTRACTS OF 100,000 CANADIAN DOLLARS)"
12/12/2000,CAD,1.528,0.95%,0.0096,5.66,-0.65,75994,3399,18260,0,45214,32652,48613,50912,27381,25082,"(CONTRACTS OF 100,000 CANADIAN DOLLARS)"
05/12/2000,CAD,1.5427,-0.42%,-0.0042,5.72,-0.69,71774,3490,21927,40,47021,26730,50551,48697,21223,23077,"(CONTRACTS OF 100,000 CANADIAN DOLLARS)"
28/11/2000,CAD,1.5362,0.90%,0.0091,5.74,-0.73,73411,4021,23202,40,47482,27451,51543,50693,21868,22718,"(CONTRACTS OF 100,000 CANADIAN DOLLARS)"
21/11/2000,CAD,1.5502,-0.26%,-0.0026,5.75,-0.79,76490,3887,31537,40,51174,23011,55101,54588,21389,21902,"(CONTRACTS OF 100,000 CANADIAN DOLLARS)"
14/11/2000,CAD,1.5462,-0.82%,-0.0082,5.75,-0.93,79013,3896,33625,174,54161,23639,58231,57438,20782,21575,"(CONTRACTS OF 100,000 CANADIAN DOLLARS)"
07/11/2000,CAD,1.5336,-0.76%,-0.0076,5.76,-0.9,79094,3480,35075,174,55523,22917,59177,58166,19917,20928,"(CONTRACTS OF 100,000 CANADIAN DOLLARS)"
31/10/2000,CAD,1.522,-0.39%,-0.0039,5.73,-0.92,81105,3916,41021,40,56410,18882,60366,59943,20739,21162,"(CONTRACTS OF 100,000 CANADIAN DOLLARS)"
24/10/2000,CAD,1.5161,0.14%,0.0014,5.7,-0.96,82404,3268,41290,43,58498,21393,61809,62726,20595,19678,"(CONTRACTS OF 100,000 CANADIAN DOLLARS)"
17/10/2000,CAD,1.5182,-1.16%,-0.0115,5.73,-0.92,84011,4022,41327,0,60928,20611,64950,61938,19061,22073,"(CONTRACTS OF 100,000 CANADIAN DOLLARS)"
10/10/2000,CAD,1.5008,0.18%,0.0018,5.75,-0.89,78505,3623,38583,0,58044,18143,61667,56726,16838,21779,"(CONTRACTS OF 100,000 CANADIAN DOLLARS)"
03/10/2000,CAD,1.5035,-1.20%,-0.012,5.76,-0.85,78505,3598,38763,0,58083,17416,61681,56179,16824,22326,"(CONTRACTS OF 100,000 CANADIAN DOLLARS)"
26/09/2000,CAD,1.4856,-0.18%,-0.0018,5.73,-0.93,59723,1590,24485,0,43650,16787,45240,41272,14483,18451,"(CONTRACTS OF 100,000 CANADIAN DOLLARS)"
19/09/2000,CAD,1.483,-0.20%,-0.002,5.73,-0.98,72763,2760,19543,0,52705,34927,55465,54470,17298,18293,"(CONTRACTS OF 100,000 CANADIAN DOLLARS)"
12/09/2000,CAD,1.48,-0.28%,-0.0028,5.72,-0.83,68219,2972,14947,6,46184,36393,49162,51346,19057,16873,"(CONTRACTS OF 100,000 CANADIAN DOLLARS)"
05/09/2000,CAD,1.4758,0.51%,0.0051,5.73,-0.85,63791,4785,13557,280,38971,36346,44036,50183,19755,13608,"(CONTRACTS OF 100,000 CANADIAN DOLLARS)"
29/08/2000,CAD,1.4834,-0.49%,-0.0049,5.75,-0.85,67795,3473,17213,280,45702,33528,49455,51021,18340,16774,"(CONTRACTS OF 100,000 CANADIAN DOLLARS)"
22/08/2000,CAD,1.4762,0.52%,0.0052,5.75,-0.84,63613,1998,14425,280,41340,33510,43618,48215,19995,15398,"(CONTRACTS OF 100,000 CANADIAN DOLLARS)"
15/08/2000,CAD,1.4839,0.19%,0.0019,5.72,-0.86,68102,3197,17475,280,45279,34113,48756,51868,19346,16234,"(CONTRACTS OF 100,000 CANADIAN DOLLARS)"
08/08/2000,CAD,1.4867,0.02%,0.0002,5.75,-0.85,65692,4783,17446,280,42049,31510,47112,49236,18580,16456,"(CONTRACTS OF 100,000 CANADIAN DOLLARS)"
01/08/2000,CAD,1.487,-1.43%,-0.0142,5.75,-0.81,65130,3794,16796,281,35951,33140,40026,50217,25104,14913,"(CONTRACTS OF 100,000 CANADIAN DOLLARS)"
25/07/2000,CAD,1.4661,0.66%,0.0066,5.75,-0.82,69355,10573,15815,292,33622,40108,44487,56215,24868,13140,"(CONTRACTS OF 100,000 CANADIAN DOLLARS)"
18/07/2000,CAD,1.4758,0.22%,0.0022,5.77,-0.86,67426,4960,23494,313,41998,29456,47271,53263,20155,14163,"(CONTRACTS OF 100,000 CANADIAN DOLLARS)"
11/07/2000,CAD,1.479,0.38%,0.0038,5.78,-0.85,66531,3653,23327,310,45392,28158,49355,51795,17176,14736,"(CONTRACTS OF 100,000 CANADIAN DOLLARS)"
05/07/2000,CAD,1.4847,-0.32%,-0.0032,5.78,-0.87,65357,3419,23213,309,43403,26717,47131,50239,18226,15118,"(CONTRACTS OF 100,000 CANADIAN DOLLARS)"
27/06/2000,CAD,1.48,-0.64%,-0.0064,5.81,-0.82,58960,2599,18897,280,36987,25219,39866,44396,19094,14564,"(CONTRACTS OF 100,000 CANADIAN DOLLARS)"
20/06/2000,CAD,1.4706,-0.19%,-0.0019,5.81,-0.84,74847,4038,18381,284,47235,40135,51557,58800,23290,16047,"(CONTRACTS OF 100,000 CANADIAN DOLLARS)"
13/06/2000,CAD,1.4678,0.61%,0.0061,5.84,-0.83,78822,4085,19002,283,47426,38732,51794,58017,27028,20805,"(CONTRACTS OF 100,000 CANADIAN DOLLARS)"
06/06/2000,CAD,1.4768,1.90%,0.0192,5.87,-0.81,68252,3161,21233,281,43857,27116,47299,48630,20953,19622,"(CONTRACTS OF 100,000 CANADIAN DOLLARS)"
30/05/2000,CAD,1.5054,0.05%,0.0005,5.87,-0.88,86836,5453,36942,280,56420,22730,62153,59952,24683,26884,"(CONTRACTS OF 100,000 CANADIAN DOLLARS)"
23/05/2000,CAD,1.5062,-1.47%,-0.0146,5.83,-0.87,82820,6178,31947,321,53026,24843,59525,57111,23295,25709,"(CONTRACTS OF 100,000 CANADIAN DOLLARS)"
16/05/2000,CAD,1.4844,0.34%,0.0034,5.82,-1,72524,6500,26334,324,42052,24165,48876,50823,23648,21701,"(CONTRACTS OF 100,000 CANADIAN DOLLARS)"
09/05/2000,CAD,1.4895,-0.27%,-0.0027,5.7,-1.07,71504,8689,21721,1106,46408,33207,56203,56034,15301,15470,"(CONTRACTS OF 100,000 CANADIAN DOLLARS)"
02/05/2000,CAD,1.4855,-1.23%,-0.0122,5.6,-1.36,71246,8693,20772,913,46456,34799,56062,56484,15184,14762,"(CONTRACTS OF 100,000 CANADIAN DOLLARS)"
25/04/2000,CAD,1.4675,0.86%,0.0087,5.37,-1.28,66751,7897,19257,926,42147,31378,50970,51561,15781,15190,"(CONTRACTS OF 100,000 CANADIAN DOLLARS)"
18/04/2000,CAD,1.4803,-1.20%,-0.0119,5.4,-1.25,67355,7441,19019,918,41874,31142,50233,51079,17122,16276,"(CONTRACTS OF 100,000 CANADIAN DOLLARS)"
11/04/2000,CAD,1.4628,-0.74%,-0.0074,5.37,-1.05,50945,4862,9047,881,28376,30655,34119,40583,16826,10362,"(CONTRACTS OF 100,000 CANADIAN DOLLARS)"
04/04/2000,CAD,1.452,0.08%,0.0008,5.38,-0.9,53474,8323,8716,858,24572,33450,33753,43024,19721,10450,"(CONTRACTS OF 100,000 CANADIAN DOLLARS)"
28/03/2000,CAD,1.4532,1.12%,0.0113,5.35,-0.92,55329,8011,10472,738,26619,30683,35368,41893,19961,13436,"(CONTRACTS OF 100,000 CANADIAN DOLLARS)"
21/03/2000,CAD,1.4697,-0.36%,-0.0035,5.29,-0.94,56963,5733,14975,1027,34030,27939,40790,43941,16173,13022,"(CONTRACTS OF 100,000 CANADIAN DOLLARS)"
14/03/2000,CAD,1.4645,-0.69%,-0.0069,5.25,-1,63071,5460,7385,1166,35441,39920,42067,48471,21004,14600,"(CONTRACTS OF 100,000 CANADIAN DOLLARS)"
07/03/2000,CAD,1.4544,-0.41%,-0.0041,5.2,-0.92,61387,6093,6978,1631,32658,44094,40382,52703,21005,8684,"(CONTRACTS OF 100,000 CANADIAN DOLLARS)"
29/02/2000,CAD,1.4484,0.86%,0.0087,5.14,-1.01,61992,8764,5135,1594,31816,47083,42174,53812,19818,8180,"(CONTRACTS OF 100,000 CANADIAN DOLLARS)"
22/02/2000,CAD,1.461,-0.41%,-0.0041,5.17,-0.91,62692,10843,6253,1240,30690,45369,42773,52862,19919,9830,"(CONTRACTS OF 100,000 CANADIAN DOLLARS)"
15/02/2000,CAD,1.455,-0.71%,-0.0071,5.12,-0.86,63502,17494,4850,1382,24096,47825,42972,54057,20530,9445,"(CONTRACTS OF 100,000 CANADIAN DOLLARS)"
08/02/2000,CAD,1.4447,0.21%,0.0021,5.15,-0.88,66877,23406,2938,1470,17263,54691,42139,59099,24738,7778,"(CONTRACTS OF 100,000 CANADIAN DOLLARS)"
01/02/2000,CAD,1.4477,-0.80%,-0.008,5.14,-0.91,66504,24091,4597,1663,16679,53184,42433,59444,24071,7060,"(CONTRACTS OF 100,000 CANADIAN DOLLARS)"
25/01/2000,CAD,1.4362,0.93%,0.0094,5.1,-0.86,73798,32165,5081,1731,14705,61875,48601,68687,25197,5111,"(CONTRACTS OF 100,000 CANADIAN DOLLARS)"
18/01/2000,CAD,1.4497,0.52%,0.0052,4.93,-1.04,63372,24509,4797,1151,14610,52480,40270,58428,23102,4944,"(CONTRACTS OF 100,000 CANADIAN DOLLARS)"
11/01/2000,CAD,1.4573,-0.38%,-0.0038,5.06,-0.9,61961,22760,12679,1161,15553,42293,39474,56133,22487,5828,"(CONTRACTS OF 100,000 CANADIAN DOLLARS)"
04/01/2000,CAD,1.4518,-0.12%,-0.0012,5.06,-0.9,61690,24810,11385,985,14961,43990,40756,56360,20934,5330,"(CONTRACTS OF 100,000 CANADIAN DOLLARS)"
28/12/1999,CAD,1.45,1.79%,0.0181,5.15,-0.79,51101,17602,10845,1019,14393,33789,33014,45653,18087,5448,"(CONTRACTS OF 100,000 CANADIAN DOLLARS)"
21/12/1999,CAD,1.4765,0.30%,0.003,5.07,-0.79,45109,6437,13085,901,23545,22172,30883,36158,14226,8951,"(CONTRACTS OF 100,000 CANADIAN DOLLARS)"
14/12/1999,CAD,1.481,-0.33%,-0.0033,4.98,-0.95,54029,6449,10067,515,29686,29907,36650,40489,17379,13540,"(CONTRACTS OF 100,000 CANADIAN DOLLARS)"
07/12/1999,CAD,1.4761,-0.17%,-0.0017,4.93,-1.05,61260,7768,10423,515,33237,35674,41520,46612,19740,14648,"(CONTRACTS OF 100,000 CANADIAN DOLLARS)"
30/11/1999,CAD,1.4736,-0.48%,-0.0048,5.02,-1.11,58571,12289,7096,687,24782,40404,37758,48187,20813,10384,"(CONTRACTS OF 100,000 CANADIAN DOLLARS)"
23/11/1999,CAD,1.4666,-0.33%,-0.0033,5.06,-0.94,62385,18279,5739,515,21184,47631,39978,53885,22407,8500,"(CONTRACTS OF 100,000 CANADIAN DOLLARS)"
16/11/1999,CAD,1.4618,0.85%,0.0085,5.03,-1.06,61403,15943,4427,762,22381,47796,39086,52985,22317,8418,"(CONTRACTS OF 100,000 CANADIAN DOLLARS)"
09/11/1999,CAD,1.4743,-0.35%,-0.0035,5.1,-0.96,59358,14828,4465,585,21734,46112,37147,51162,22211,8196,"(CONTRACTS OF 100,000 CANADIAN DOLLARS)"
02/11/1999,CAD,1.4692,0.26%,0.0026,5,-0.9,56413,10192,3936,420,26812,44098,37424,48454,18989,7959,"(CONTRACTS OF 100,000 CANADIAN DOLLARS)"
26/10/1999,CAD,1.473,1.06%,0.0107,5.13,-0.87,52319,7022,3807,220,27103,40313,34345,44340,17974,7979,"(CONTRACTS OF 100,000 CANADIAN DOLLARS)"
19/10/1999,CAD,1.4888,-0.89%,-0.0089,5.15,-0.84,53655,5485,6760,596,29463,33614,35544,40970,18111,12685,"(CONTRACTS OF 100,000 CANADIAN DOLLARS)"
12/10/1999,CAD,1.4756,-0.25%,-0.0025,5.03,-1.04,63872,20811,5288,96,20703,49692,41610,55076,22262,8796,"(CONTRACTS OF 100,000 CANADIAN DOLLARS)"
05/10/1999,CAD,1.4719,-0.73%,-0.0073,5,-1.08,64521,21182,5254,329,20635,51304,42146,56887,22375,7634,"(CONTRACTS OF 100,000 CANADIAN DOLLARS)"
28/09/1999,CAD,1.4612,1.00%,0.0101,4.69,-1.47,60305,16861,4292,113,20161,48344,37135,52749,23170,7556,"(CONTRACTS OF 100,000 CANADIAN DOLLARS)"
21/09/1999,CAD,1.476,-0.17%,-0.0017,4.77,-1.33,52901,12658,5256,324,20529,38929,33511,44509,19390,8392,"(CONTRACTS OF 100,000 CANADIAN DOLLARS)"
14/09/1999,CAD,1.4735,1.05%,0.0105,4.71,-1.3,73156,6692,4634,12,47974,58645,54678,63291,18478,9865,"(CONTRACTS OF 100,000 CANADIAN DOLLARS)"
07/09/1999,CAD,1.4891,0.17%,0.0017,4.76,-0.64,71695,5723,9865,298,49086,48025,55107,58188,16588,13507,"(CONTRACTS OF 100,000 CANADIAN DOLLARS)"
31/08/1999,CAD,1.4917,-0.09%,-0.0009,4.85,-0.61,68733,6043,11851,298,47567,44491,53908,56640,14825,12093,"(CONTRACTS OF 100,000 CANADIAN DOLLARS)"
24/08/1999,CAD,1.4903,-0.91%,-0.009,4.87,-0.58,66844,5557,12201,42,45146,43532,50745,55775,16099,11069,"(CONTRACTS OF 100,000 CANADIAN DOLLARS)"
17/08/1999,CAD,1.4769,1.33%,0.0134,4.87,-0.58,66156,6560,11381,201,43000,44370,49761,55952,16395,10204,"(CONTRACTS OF 100,000 CANADIAN DOLLARS)"
10/08/1999,CAD,1.4968,-0.28%,-0.0028,4.87,-0.53,76379,6656,24226,373,53537,37079,60566,61678,15813,14701,"(CONTRACTS OF 100,000 CANADIAN DOLLARS)"
03/08/1999,CAD,1.4926,1.34%,0.0135,4.81,-0.53,84345,6374,35589,0,62707,32622,69081,68211,15264,16134,"(CONTRACTS OF 100,000 CANADIAN DOLLARS)"
27/07/1999,CAD,1.5129,-1.44%,-0.0143,4.74,-0.6,75262,5195,30126,276,54458,31824,59929,62226,15333,13036,"(CONTRACTS OF 100,000 CANADIAN DOLLARS)"
20/07/1999,CAD,1.4914,-0.79%,-0.0079,4.65,-0.65,61710,12776,10332,394,33588,38433,46758,49159,14952,12551,"(CONTRACTS OF 100,000 CANADIAN DOLLARS)"
13/07/1999,CAD,1.4797,-0.61%,-0.0061,4.65,-0.67,62623,13424,5206,300,27928,43546,41652,49052,20971,13571,"(CONTRACTS OF 100,000 CANADIAN DOLLARS)"
06/07/1999,CAD,1.4707,0.39%,0.0039,4.63,-0.56,61270,18634,3505,321,20839,50069,39794,53895,21476,7375,"(CONTRACTS OF 100,000 CANADIAN DOLLARS)"
29/06/1999,CAD,1.4765,-0.48%,-0.0048,4.62,-0.59,62374,22580,2898,912,18650,51082,42142,54892,20232,7482,"(CONTRACTS OF 100,000 CANADIAN DOLLARS)"
22/06/1999,CAD,1.4695,-0.37%,-0.0037,4.71,-0.52,62240,21823,2615,338,18585,52087,40746,55040,21494,7200,"(CONTRACTS OF 100,000 CANADIAN DOLLARS)"
15/06/1999,CAD,1.4641,0.75%,0.0075,4.69,-0.56,83577,23824,3560,282,36492,71160,60598,75002,22979,8575,"(CONTRACTS OF 100,000 CANADIAN DOLLARS)"
08/06/1999,CAD,1.4751,0.57%,0.0057,4.69,-0.52,85077,23606,4089,413,36354,70006,60373,74508,24704,10569,"(CONTRACTS OF 100,000 CANADIAN DOLLARS)"
01/06/1999,CAD,1.4835,-1.13%,-0.0113,4.68,-0.44,77848,25017,3197,1525,26120,60567,52662,65289,25186,12559,"(CONTRACTS OF 100,000 CANADIAN DOLLARS)"
25/05/1999,CAD,1.4669,0.01%,0.0001,4.6,-0.41,84475,31589,2976,1320,23925,71349,56834,75645,27641,8830,"(CONTRACTS OF 100,000 CANADIAN DOLLARS)"
18/05/1999,CAD,1.4671,-1.04%,-0.0103,4.46,-0.57,87144,35044,4146,1785,22413,72662,59242,78593,27902,8551,"(CONTRACTS OF 100,000 CANADIAN DOLLARS)"
11/05/1999,CAD,1.452,-0.02%,-0.0002,4.43,-0.48,84985,35282,4117,1448,20060,70660,56790,76225,28195,8760,"(CONTRACTS OF 100,000 CANADIAN DOLLARS)"
04/05/1999,CAD,1.4517,1.90%,0.0192,4.46,-0.47,84922,35794,4030,930,18843,70523,55567,75483,29355,9439,"(CONTRACTS OF 100,000 CANADIAN DOLLARS)"
27/04/1999,CAD,1.4798,0.62%,0.0062,4.6,-0.3,83465,35749,3559,614,17565,70028,53928,74201,29537,9264,"(CONTRACTS OF 100,000 CANADIAN DOLLARS)"
20/04/1999,CAD,1.489,0.10%,0.001,4.53,-0.34,79692,32135,3480,300,19553,66770,51988,70550,27704,9142,"(CONTRACTS OF 100,000 CANADIAN DOLLARS)"
13/04/1999,CAD,1.4905,0.77%,0.0077,4.48,4.48,70341,23269,4138,226,20411,55230,43906,59594,26435,10747,"(CONTRACTS OF 100,000 CANADIAN DOLLARS)"
06/04/1999,CAD,1.502,0.54%,0.0054,4.69,-0.17,59329,12648,2955,315,20798,46149,33761,49419,25568,9910,"(CONTRACTS OF 100,000 CANADIAN DOLLARS)"
30/03/1999,CAD,1.5102,-0.20%,-0.002,4.81,-0.06,54803,9735,3272,550,22125,41537,32410,45359,22393,9444,"(CONTRACTS OF 100,000 CANADIAN DOLLARS)"
23/03/1999,CAD,1.5072,1.39%,0.014,4.9,0.01,55557,12534,2331,1150,19550,42930,33234,46411,22323,9146,"(CONTRACTS OF 100,000 CANADIAN DOLLARS)"
16/03/1999,CAD,1.5285,-0.64%,-0.0064,4.89,-0.01,72693,9432,3394,864,27100,50526,37396,54784,35297,17909,"(CONTRACTS OF 100,000 CANADIAN DOLLARS)"
09/03/1999,CAD,1.5188,0.15%,0.0015,4.96,0.06,72008,10980,3228,0,32652,51780,43632,55008,28376,17000,"(CONTRACTS OF 100,000 CANADIAN DOLLARS)"
02/03/1999,CAD,1.5211,-1.74%,-0.0172,4.94,0,70181,13844,3578,928,26490,49669,41262,54175,28919,16006,"(CONTRACTS OF 100,000 CANADIAN DOLLARS)"
23/02/1999,CAD,1.4951,-0.09%,-0.0009,4.94,0.07,79306,18485,2639,892,25926,59497,45303,63028,34003,16278,"(CONTRACTS OF 100,000 CANADIAN DOLLARS)"
16/02/1999,CAD,1.4937,0.08%,0.0008,4.93,0.01,76337,18988,2941,661,25531,59073,45180,62675,31157,13662,"(CONTRACTS OF 100,000 CANADIAN DOLLARS)"
09/02/1999,CAD,1.4949,1.29%,0.013,4.88,-0.06,70696,17092,2399,888,24226,54590,42206,57877,28490,12819,"(CONTRACTS OF 100,000 CANADIAN DOLLARS)"
02/02/1999,CAD,1.5145,0.36%,0.0036,4.93,0.04,57132,7380,4034,896,26508,39527,34784,44457,22348,12675,"(CONTRACTS OF 100,000 CANADIAN DOLLARS)"
26/01/1999,CAD,1.52,0.58%,0.0058,4.82,-0.09,51323,6093,2746,898,22845,37121,29836,40765,21487,10558,"(CONTRACTS OF 100,000 CANADIAN DOLLARS)"
19/01/1999,CAD,1.5288,-1.04%,-0.0104,4.81,-0.09,50810,6488,3327,869,22196,37646,29553,41842,21257,8968,"(CONTRACTS OF 100,000 CANADIAN DOLLARS)"
12/01/1999,CAD,1.513,-0.07%,-0.0007,4.88,0,51921,11357,3044,857,17220,38914,29434,42815,22487,9106,"(CONTRACTS OF 100,000 CANADIAN DOLLARS)"
05/01/1999,CAD,1.512,2.51%,0.0255,4.81,-0.03,44072,4638,3943,876,21272,30578,26786,35397,17286,8675,"(CONTRACTS OF 100,000 CANADIAN DOLLARS)"
29/12/1998,CAD,1.551,0.10%,0.001,4.87,0.04,39871,1851,10126,857,23914,16972,26622,27955,13249,11916,"(CONTRACTS OF 100,000 CANADIAN DOLLARS)"
22/12/1998,CAD,1.5526,-0.75%,-0.0075,4.65,-0.29,39710,1804,10010,810,23510,17328,26124,28148,13586,11562,"(CONTRACTS OF 100,000 CANADIAN DOLLARS)"
15/12/1998,CAD,1.541,0.18%,0.0018,4.86,-0.07,57842,2213,7751,809,39367,40663,42389,49223,15453,8619,"(CONTRACTS OF 100,000 CANADIAN DOLLARS)"
08/12/1998,CAD,1.5438,-0.84%,-0.0083,4.87,-0.31,59112,2329,7683,802,39154,40378,42285,48863,16827,10249,"(CONTRACTS OF 100,000 CANADIAN DOLLARS)"
01/12/1998,CAD,1.531,1.25%,0.0126,4.87,-0.25,65472,3915,6677,2088,37460,41136,43463,49901,22009,15571,"(CONTRACTS OF 100,000 CANADIAN DOLLARS)"
24/11/1998,CAD,1.5504,-0.25%,-0.0025,4.84,-0.25,63624,2166,8243,2046,36660,37705,40872,47994,22752,15630,"(CONTRACTS OF 100,000 CANADIAN DOLLARS)"
17/11/1998,CAD,1.5465,-0.19%,-0.0019,4.87,-0.25,63048,2571,7819,2055,37576,38695,42202,48569,20846,14479,"(CONTRACTS OF 100,000 CANADIAN DOLLARS)"
10/11/1998,CAD,1.5435,-1.28%,-0.0127,5.09,-0.06,60716,3137,4914,1859,35292,40815,40288,47588,20428,13128,"(CONTRACTS OF 100,000 CANADIAN DOLLARS)"
03/11/1998,CAD,1.524,1.18%,0.0119,5.17,-0.02,56026,2263,3912,2057,31238,38728,35558,44697,20468,11329,"(CONTRACTS OF 100,000 CANADIAN DOLLARS)"
27/10/1998,CAD,1.5422,-0.34%,-0.0034,5.06,-0.25,52934,2110,5094,2068,29825,34577,34003,41739,18931,11195,"(CONTRACTS OF 100,000 CANADIAN DOLLARS)"
20/10/1998,CAD,1.537,0.61%,0.0062,5.06,-0.25,51585,2309,5152,2017,28730,34055,33056,41224,18529,10361,"(CONTRACTS OF 100,000 CANADIAN DOLLARS)"
13/10/1998,CAD,1.5465,0.08%,0.0008,5.25,0.1,50240,2229,5831,1976,29308,31578,33513,39385,16727,10855,"(CONTRACTS OF 100,000 CANADIAN DOLLARS)"
06/10/1998,CAD,1.5477,-2.08%,-0.0206,5.28,0.19,51219,2499,6798,1589,30097,29407,34185,37794,17034,13425,"(CONTRACTS OF 100,000 CANADIAN DOLLARS)"
29/09/1998,CAD,1.5162,0.85%,0.0085,5.21,0.12,52049,2007,5430,1453,30162,34817,33622,41700,18427,10349,"(CONTRACTS OF 100,000 CANADIAN DOLLARS)"
22/09/1998,CAD,1.5292,-1.82%,-0.0181,5.46,0.18,51581,1979,7412,1043,32713,31028,35735,39483,15846,12098,"(CONTRACTS OF 100,000 CANADIAN DOLLARS)"
15/09/1998,CAD,1.5018,1.07%,0.0107,5.34,0.12,65301,2907,9135,1458,42642,42085,47007,52678,18294,12623,"(CONTRACTS OF 100,000 CANADIAN DOLLARS)"
08/09/1998,CAD,1.518,2.03%,0.0205,5.62,0.41,71659,5375,13057,2166,44769,42410,52310,57633,19349,14026,"(CONTRACTS OF 100,000 CANADIAN DOLLARS)"
01/09/1998,CAD,1.5495,0.00%,0,5.75,0.19,73780,5264,16285,2327,43359,36428,50950,55040,22830,18740,"(CONTRACTS OF 100,000 CANADIAN DOLLARS)"
25/08/1998,CAD,1.5495,-1.35%,-0.0134,4.96,-0.41,75626,4953,27254,1830,49526,26958,56309,56042,19317,19584,"(CONTRACTS OF 100,000 CANADIAN DOLLARS)"
18/08/1998,CAD,1.5289,-0.45%,-0.0045,4.9,-0.6,77200,4273,26926,1942,51077,30316,57292,59184,19908,18016,"(CONTRACTS OF 100,000 CANADIAN DOLLARS)"
11/08/1998,CAD,1.522,-0.40%,-0.0039,5.09,-0.41,72943,4841,26672,1927,45835,27258,52603,55857,20340,17086,"(CONTRACTS OF 100,000 CANADIAN DOLLARS)"
04/08/1998,CAD,1.516,-1.00%,-0.0099,5.1,-0.46,73331,4278,27610,2018,45999,25764,52295,55392,21036,17939,"(CONTRACTS OF 100,000 CANADIAN DOLLARS)"
28/07/1998,CAD,1.501,-0.67%,-0.0067,5,-0.56,71906,4624,26962,2009,44844,27159,51477,56130,20429,15776,"(CONTRACTS OF 100,000 CANADIAN DOLLARS)"
21/07/1998,CAD,1.491,-0.68%,-0.0068,4.96,-0.62,72088,5034,25228,2045,44853,28493,51932,55766,20156,16322,"(CONTRACTS OF 100,000 CANADIAN DOLLARS)"
14/07/1998,CAD,1.4809,-0.64%,-0.0064,4.87,-0.69,70340,4594,23398,2023,41985,29208,48602,54629,21738,15711,"(CONTRACTS OF 100,000 CANADIAN DOLLARS)"
07/07/1998,CAD,1.4715,-0.35%,-0.0035,4.87,-0.72,69815,4286,25434,1991,40528,27671,46805,55096,23010,14719,"(CONTRACTS OF 100,000 CANADIAN DOLLARS)"
30/06/1998,CAD,1.4664,0.27%,0.0027,4.87,-0.69,68815,4104,26601,2011,41239,25568,47354,54180,21461,14635,"(CONTRACTS OF 100,000 CANADIAN DOLLARS)"
23/06/1998,CAD,1.4704,-0.01%,-0.0001,4.9,-0.69,67433,5304,26960,1758,39667,23932,46729,52650,20704,14783,"(CONTRACTS OF 100,000 CANADIAN DOLLARS)"
16/06/1998,CAD,1.4703,-0.80%,-0.0079,4.93,-0.63,86700,4880,29661,2712,58838,35941,66430,68314,20270,18386,"(CONTRACTS OF 100,000 CANADIAN DOLLARS)"
09/06/1998,CAD,1.4587,-0.62%,-0.0062,4.81,-0.75,80094,4336,23703,2863,45446,34428,52645,60994,27449,19100,"(CONTRACTS OF 100,000 CANADIAN DOLLARS)"
02/06/1998,CAD,1.4497,0.33%,0.0033,4.87,-0.69,70537,4880,24165,624,39430,27913,44934,52702,25603,17835,"(CONTRACTS OF 100,000 CANADIAN DOLLARS)"
26/05/1998,CAD,1.4545,-0.47%,-0.0047,5.09,-0.47,70687,4728,23496,1537,39431,29710,45696,54743,24991,15944,"(CONTRACTS OF 100,000 CANADIAN DOLLARS)"
19/05/1998,CAD,1.4477,-0.94%,-0.0094,4.87,-0.69,67254,3511,22686,1523,36382,27816,41416,52025,25838,15229,"(CONTRACTS OF 100,000 CANADIAN DOLLARS)"
12/05/1998,CAD,1.4342,0.35%,0.0035,4.88,-0.71,61808,3792,13295,1511,30798,34273,36101,49079,25707,12729,"(CONTRACTS OF 100,000 CANADIAN DOLLARS)"
05/05/1998,CAD,1.4393,0.00%,0,4.87,-0.72,60297,3218,12538,1511,29481,34076,34210,48125,26087,12172,"(CONTRACTS OF 100,000 CANADIAN DOLLARS)"
28/04/1998,CAD,1.4393,-0.54%,-0.0054,5.08,-0.51,59705,2808,11687,1511,29505,33100,33824,46298,25881,13407,"(CONTRACTS OF 100,000 CANADIAN DOLLARS)"
21/04/1998,CAD,1.4315,0.10%,0.001,4.84,-0.72,58919,3037,10427,1510,28302,34134,32849,46071,26070,12848,"(CONTRACTS OF 100,000 CANADIAN DOLLARS)"
14/04/1998,CAD,1.433,-0.73%,-0.0073,4.76,-0.8,59612,5556,9170,1483,25662,35289,32701,45942,26911,13670,"(CONTRACTS OF 100,000 CANADIAN DOLLARS)"
07/04/1998,CAD,1.4226,-0.20%,-0.002,4.68,-0.95,57121,5779,3011,1455,19427,42301,26661,46767,30460,10354,"(CONTRACTS OF 100,000 CANADIAN DOLLARS)"
31/03/1998,CAD,1.4197,-0.28%,-0.0028,4.78,-0.78,58818,6961,2843,1483,19527,43444,27971,47770,30847,11048,"(CONTRACTS OF 100,000 CANADIAN DOLLARS)"
24/03/1998,CAD,1.4158,0.07%,0.0007,4.63,-0.93,53446,6764,2690,1421,16396,41495,24581,45606,28865,7840,"(CONTRACTS OF 100,000 CANADIAN DOLLARS)"
17/03/1998,CAD,1.4168,-0.56%,-0.0056,4.62,-0.94,67562,6795,1908,1429,29418,55382,37642,58719,29920,8843,"(CONTRACTS OF 100,000 CANADIAN DOLLARS)"
10/03/1998,CAD,1.4089,0.91%,0.0091,4.68,-0.91,68037,4962,1768,1357,29700,52263,36019,55388,32018,12649,"(CONTRACTS OF 100,000 CANADIAN DOLLARS)"
03/03/1998,CAD,1.4218,-0.01%,-0.0001,4.65,-0.91,68465,3734,7734,2310,32333,46141,38377,56185,30088,12280,"(CONTRACTS OF 100,000 CANADIAN DOLLARS)"
24/02/1998,CAD,1.4216,1.16%,0.0117,4.8,-0.76,70658,3754,7485,2687,35695,48759,42136,58931,28522,11727,"(CONTRACTS OF 100,000 CANADIAN DOLLARS)"
17/02/1998,CAD,1.4383,-0.31%,-0.0031,4.87,-0.63,68889,2275,11324,2694,36997,40884,41966,54902,26923,13987,"(CONTRACTS OF 100,000 CANADIAN DOLLARS)"
10/02/1998,CAD,1.4339,0.93%,0.0094,4.68,-0.85,64827,2984,10972,2880,32266,36292,38130,50144,26697,14683,"(CONTRACTS OF 100,000 CANADIAN DOLLARS)"
03/02/1998,CAD,1.4474,0.60%,0.006,4.88,-0.65,67444,2682,18352,2900,33432,28955,39014,50207,28430,17237,"(CONTRACTS OF 100,000 CANADIAN DOLLARS)"
27/01/1998,CAD,1.4561,-1.01%,-0.0101,4.37,-1.13,64419,3295,20207,2708,32179,25293,38182,48208,26237,16211,"(CONTRACTS OF 100,000 CANADIAN DOLLARS)"
20/01/1998,CAD,1.4415,-0.54%,-0.0054,4.53,-0.97,63599,3716,17448,2661,30696,27948,37073,48057,26526,15542,"(CONTRACTS OF 100,000 CANADIAN DOLLARS)"
13/01/1998,CAD,1.4338,-0.13%,-0.0013,4.47,-1.01,62101,3180,17912,2564,29925,26922,35669,47398,26432,14703,"(CONTRACTS OF 100,000 CANADIAN DOLLARS)"
06/01/1998,CAD,1.432,0.00%,0,4.59,-0.93,62751,3846,23115,2538,31395,21346,37779,46999,24972,15752,"(CONTRACTS OF 100,000 CANADIAN DOLLARS)"
30/12/1997,CAD,1.432,0.44%,0.0044,4.73,-0.77,66115,3815,25212,2392,36559,23063,42766,50667,23349,15448,"(CONTRACTS OF 100,000 CANADIAN DOLLARS)"
23/12/1997,CAD,1.4383,-0.90%,-0.0089,4.75,-0.75,65173,4860,25244,2350,36398,23767,43608,51361,21565,13812,"(CONTRACTS OF 100,000 CANADIAN DOLLARS)"
16/12/1997,CAD,1.4255,-0.22%,-0.0022,4.5,-1,84023,3919,20128,2160,52992,42841,59071,65129,24952,18894,"(CONTRACTS OF 100,000 CANADIAN DOLLARS)"
09/12/1997,CAD,1.4224,-0.25%,-0.0025,4.12,-1.56,86967,3895,22673,1138,54836,46810,59869,70621,27098,16346,"(CONTRACTS OF 100,000 CANADIAN DOLLARS)"
02/12/1997,CAD,1.4189,-0.18%,-0.0018,4.13,4.13,75838,3922,23430,651,40215,31544,44788,55625,31050,20213,"(CONTRACTS OF 100,000 CANADIAN DOLLARS)"
25/11/1997,CAD,1.4163,-0.18%,-0.0018,3.93,-1.85,77709,4301,25218,1489,41410,30825,47200,57532,30509,20177,"(CONTRACTS OF 100,000 CANADIAN DOLLARS)"
18/11/1997,CAD,1.4138,-0.48%,-0.0048,3.87,-1.88,74605,3974,25705,1215,42652,31970,47841,58890,26764,15715,"(CONTRACTS OF 100,000 CANADIAN DOLLARS)"
11/11/1997,CAD,1.407,-0.43%,-0.0043,3.87,-1.9,71927,3844,25940,1145,42693,30347,47682,57432,24245,14495,"(CONTRACTS OF 100,000 CANADIAN DOLLARS)"
04/11/1997,CAD,1.401,0.07%,0.0007,3.87,-1.94,74076,4285,29788,1107,45831,28491,51223,59386,22853,14690,"(CONTRACTS OF 100,000 CANADIAN DOLLARS)"
28/10/1997,CAD,1.402,-0.89%,-0.0088,3.81,-1.94,72943,3837,29903,746,44210,27472,48793,58121,24150,14822,"(CONTRACTS OF 100,000 CANADIAN DOLLARS)"
21/10/1997,CAD,1.3897,-0.60%,-0.006,3.68,-1.91,55131,6145,14300,427,23453,31227,30025,45954,25106,9177,"(CONTRACTS OF 100,000 CANADIAN DOLLARS)"
14/10/1997,CAD,1.3814,-0.76%,-0.0076,3.62,-2.06,54173,11151,9111,426,14953,36130,26530,45667,27643,8506,"(CONTRACTS OF 100,000 CANADIAN DOLLARS)"
07/10/1997,CAD,1.371,0.76%,0.0076,3.56,-2.09,58958,17913,7622,967,12184,42326,31064,50915,27894,8043,"(CONTRACTS OF 100,000 CANADIAN DOLLARS)"
30/09/1997,CAD,1.3815,0.63%,0.0063,3.59,-2.09,49379,8514,10243,416,17061,29725,25991,40384,23388,8995,"(CONTRACTS OF 100,000 CANADIAN DOLLARS)"
23/09/1997,CAD,1.3903,-0.22%,-0.0022,3.43,-2.19,49901,5505,15576,409,23459,23492,29373,39477,20528,10424,"(CONTRACTS OF 100,000 CANADIAN DOLLARS)"
16/09/1997,CAD,1.3873,-0.24%,-0.0024,3.31,-2.37,62926,6005,15135,533,33742,36125,40280,51793,22646,11133,"(CONTRACTS OF 100,000 CANADIAN DOLLARS)"
09/09/1997,CAD,1.384,-0.06%,-0.0006,3.5,-2.12,61756,6341,9254,438,26942,39857,33721,49549,28035,12207,"(CONTRACTS OF 100,000 CANADIAN DOLLARS)"
02/09/1997,CAD,1.3832,0.70%,0.0071,3.47,-2.09,62757,4950,10705,0,28059,37784,33009,48489,29748,14268,"(CONTRACTS OF 100,000 CANADIAN DOLLARS)"
26/08/1997,CAD,1.393,0.09%,0.0009,3.45,-2.11,70373,5114,20302,1181,35969,34167,42264,55650,28109,14723,"(CONTRACTS OF 100,000 CANADIAN DOLLARS)"
19/08/1997,CAD,1.3943,-0.10%,-0.001,3.35,-2.29,64364,5080,19512,1183,31181,28623,37444,49318,26920,15046,"(CONTRACTS OF 100,000 CANADIAN DOLLARS)"
12/08/1997,CAD,1.3929,-0.92%,-0.0092,3.46,-2.1,57100,4478,13426,1261,26264,28325,32003,43012,25097,14088,"(CONTRACTS OF 100,000 CANADIAN DOLLARS)"
05/08/1997,CAD,1.3802,0.27%,0.0027,3.5,-2.11,45845,4012,8175,1138,16833,27146,21983,36459,23862,9386,"(CONTRACTS OF 100,000 CANADIAN DOLLARS)"
29/07/1997,CAD,1.384,-0.37%,-0.0037,3.43,-2.16,45305,4298,9232,1122,16333,25782,21753,36136,23552,9169,"(CONTRACTS OF 100,000 CANADIAN DOLLARS)"
22/07/1997,CAD,1.3789,-0.58%,-0.0057,3.45,-2.14,43465,4367,5441,1742,13489,27731,19598,34914,23867,8551,"(CONTRACTS OF 100,000 CANADIAN DOLLARS)"
15/07/1997,CAD,1.371,0.23%,0.0023,3.31,-2.28,43544,3999,6547,1416,12502,27311,17917,35274,25627,8270,"(CONTRACTS OF 100,000 CANADIAN DOLLARS)"
08/07/1997,CAD,1.3741,0.39%,0.0039,3.31,-2.25,43168,4297,5393,1242,12713,28423,18252,35058,24916,8110,"(CONTRACTS OF 100,000 CANADIAN DOLLARS)"
01/07/1997,CAD,1.3795,0.79%,0.0079,3.46,-2.1,43224,2628,6233,1635,15322,27744,19585,35612,23639,7612,"(CONTRACTS OF 100,000 CANADIAN DOLLARS)"
24/06/1997,CAD,1.3905,-0.32%,-0.0032,3.06,-2.54,42957,2117,5770,1690,16437,26774,20244,34234,22713,8723,"(CONTRACTS OF 100,000 CANADIAN DOLLARS)"
17/06/1997,CAD,1.3861,0.09%,0.0009,3,-2.56,67533,3099,4844,1172,33156,52048,37427,58064,30106,9469,"(CONTRACTS OF 100,000 CANADIAN DOLLARS)"
10/06/1997,CAD,1.3874,-0.82%,-0.0082,3.03,-2.56,67393,3025,6039,282,36506,51881,39813,58202,27580,9191,"(CONTRACTS OF 100,000 CANADIAN DOLLARS)"
03/06/1997,CAD,1.3761,0.69%,0.007,3.12,-2.57,70087,5319,5352,1791,32400,53920,39510,61063,30577,9024,"(CONTRACTS OF 100,000 CANADIAN DOLLARS)"
27/05/1997,CAD,1.3857,-1.41%,-0.014,3.09,-2.55,69553,6263,5802,1919,34204,53006,42386,60727,27167,8826,"(CONTRACTS OF 100,000 CANADIAN DOLLARS)"
20/05/1997,CAD,1.3665,1.39%,0.014,3.27,-2.35,68670,7107,10370,1938,31309,46771,40354,59079,28316,9591,"(CONTRACTS OF 100,000 CANADIAN DOLLARS)"
13/05/1997,CAD,1.3857,-0.54%,-0.0054,3.09,-2.59,76830,4832,14914,1664,44642,48814,51138,65392,25692,11438,"(CONTRACTS OF 100,000 CANADIAN DOLLARS)"
06/05/1997,CAD,1.3782,1.37%,0.0138,3.18,-2.5,76382,5339,13879,1903,42664,50378,49906,66160,26476,10222,"(CONTRACTS OF 100,000 CANADIAN DOLLARS)"
29/04/1997,CAD,1.3974,-0.17%,-0.0017,3.21,-2.47,82815,4694,19164,1986,53815,48178,60495,69328,22320,13487,"(CONTRACTS OF 100,000 CANADIAN DOLLARS)"
22/04/1997,CAD,1.395,0.12%,0.0012,3.25,-2.48,84497,4427,20605,1956,56892,47842,63275,70403,21222,14094,"(CONTRACTS OF 100,000 CANADIAN DOLLARS)"
15/04/1997,CAD,1.3967,-0.63%,-0.0062,3.25,-2.31,84124,4608,20848,2044,55815,46566,62467,69458,21657,14666,"(CONTRACTS OF 100,000 CANADIAN DOLLARS)"
08/04/1997,CAD,1.388,0.06%,0.0006,3.43,-2.13,81384,3081,20330,2023,52763,44985,57867,67338,23517,14046,"(CONTRACTS OF 100,000 CANADIAN DOLLARS)"
01/04/1997,CAD,1.3888,-0.76%,-0.0076,3.4,-2.31,78679,4927,19660,1803,48161,43691,54891,65154,23788,13525,"(CONTRACTS OF 100,000 CANADIAN DOLLARS)"
25/03/1997,CAD,1.3783,-0.40%,-0.004,3.12,-2.58,74773,5060,19592,1742,44394,42039,51196,63373,23577,11400,"(CONTRACTS OF 100,000 CANADIAN DOLLARS)"
18/03/1997,CAD,1.3728,-0.43%,-0.0043,3.12,-2.56,75819,5007,16994,1731,44171,45742,50909,64467,24910,11352,"(CONTRACTS OF 100,000 CANADIAN DOLLARS)"
11/03/1997,CAD,1.3669,0.18%,0.0018,3.06,-2.75,74320,5015,14750,555,41071,49166,46641,64471,27679,9849,"(CONTRACTS OF 100,000 CANADIAN DOLLARS)"
04/03/1997,CAD,1.3694,-0.73%,-0.0073,2.96,-2.72,62862,2856,13562,837,32422,38395,36115,52794,26747,10068,"(CONTRACTS OF 100,000 CANADIAN DOLLARS)"
25/02/1997,CAD,1.3595,-0.36%,-0.0036,2.87,-2.5,56461,2478,5532,1119,27467,41114,31064,47765,25397,8696,"(CONTRACTS OF 100,000 CANADIAN DOLLARS)"
18/02/1997,CAD,1.3546,0.04%,0.0004,3.03,-2.42,56628,4642,3477,1399,23491,44884,29532,49760,27096,6868,"(CONTRACTS OF 100,000 CANADIAN DOLLARS)"
11/02/1997,CAD,1.3552,-0.83%,-0.0083,3,-2.43,54206,3359,3432,1182,25065,42119,29606,46733,24600,7473,"(CONTRACTS OF 100,000 CANADIAN DOLLARS)"
04/02/1997,CAD,1.344,-0.30%,-0.003,2.93,-2.45,55453,5832,3867,1416,24105,44011,31353,49294,24100,6159,"(CONTRACTS OF 100,000 CANADIAN DOLLARS)"
28/01/1997,CAD,1.34,-0.25%,-0.0025,3.03,-2.28,54495,6226,2843,1974,23786,43637,31986,48454,22509,6041,"(CONTRACTS OF 100,000 CANADIAN DOLLARS)"
21/01/1997,CAD,1.3366,1.10%,0.0111,2.93,-2.42,52257,6605,2863,1798,21201,42266,29604,46927,22653,5330,"(CONTRACTS OF 100,000 CANADIAN DOLLARS)"
14/01/1997,CAD,1.3515,0.33%,0.0033,3.15,-2.25,54037,6733,4932,1613,24596,39634,32942,46179,21095,7858,"(CONTRACTS OF 100,000 CANADIAN DOLLARS)"
07/01/1997,CAD,1.356,1.07%,0.0107,3.14,-2.48,60630,6130,10360,1605,31006,39005,38741,50970,21889,9660,"(CONTRACTS OF 100,000 CANADIAN DOLLARS)"
31/12/1996,CAD,1.3706,-0.41%,-0.0041,2.87,-2.69,68803,17955,17238,1600,27832,39925,47387,58763,21416,10040,"(CONTRACTS OF 100,000 CANADIAN DOLLARS)"
24/12/1996,CAD,1.365,-0.12%,-0.0012,3.03,-2.38,63184,16423,13509,1269,25749,38385,43441,53163,19743,10021,"(CONTRACTS OF 100,000 CANADIAN DOLLARS)"
17/12/1996,CAD,1.3634,-0.41%,-0.0041,3.16,-2.24,81456,17330,13031,823,42143,56451,60296,70305,21160,11151,"(CONTRACTS OF 100,000 CANADIAN DOLLARS)"
10/12/1996,CAD,1.3578,-0.59%,-0.0059,3,-2.4,78507,12858,10953,1001,41169,56481,55028,68435,23479,10072,"(CONTRACTS OF 100,000 CANADIAN DOLLARS)"
03/12/1996,CAD,1.3498,-0.56%,-0.0056,2.87,-2.56,73121,17979,3003,532,29926,58930,48437,62465,24684,10656,"(CONTRACTS OF 100,000 CANADIAN DOLLARS)"
26/11/1996,CAD,1.3423,-0.04%,-0.0004,2.84,-2.84,77569,29518,1742,469,19847,67362,49834,69573,27735,7996,"(CONTRACTS OF 100,000 CANADIAN DOLLARS)"
19/11/1996,CAD,1.3417,-0.68%,-0.0067,2.87,-2.53,76972,31536,958,726,17670,67152,49932,68836,27040,8136,"(CONTRACTS OF 100,000 CANADIAN DOLLARS)"
12/11/1996,CAD,1.3327,-0.17%,-0.0017,2.87,-2.54,89808,46780,971,864,11601,81584,59245,83419,30563,6389,"(CONTRACTS OF 100,000 CANADIAN DOLLARS)"
05/11/1996,CAD,1.3305,1.00%,0.01,2.84,-2.53,85426,42743,1213,747,11136,76529,54626,78489,30800,6937,"(CONTRACTS OF 100,000 CANADIAN DOLLARS)"
29/10/1996,CAD,1.3439,0.08%,0.0008,3.2,-2.3,77686,39177,1275,952,9828,68432,49957,70659,27729,7027,"(CONTRACTS OF 100,000 CANADIAN DOLLARS)"
22/10/1996,CAD,1.345,0.70%,0.007,3.28,-2.05,70122,32647,1630,845,9883,62175,43375,64650,26747,5472,"(CONTRACTS OF 100,000 CANADIAN DOLLARS)"
15/10/1996,CAD,1.3545,-0.07%,-0.0007,3.37,-2,68361,30858,2190,1251,10595,58192,42704,61633,25657,6728,"(CONTRACTS OF 100,000 CANADIAN DOLLARS)"
08/10/1996,CAD,1.3536,0.40%,0.004,3.55,-1.8,64746,29508,1525,1060,9230,56703,39798,59288,24948,5458,"(CONTRACTS OF 100,000 CANADIAN DOLLARS)"
01/10/1996,CAD,1.359,0.57%,0.0057,3.87,-1.53,51335,15106,3597,804,13559,41941,29469,46342,21866,4993,"(CONTRACTS OF 100,000 CANADIAN DOLLARS)"
24/09/1996,CAD,1.3668,0.28%,0.0028,4.03,-1.53,38003,8271,2127,633,12314,29005,21218,31765,16785,6238,"(CONTRACTS OF 100,000 CANADIAN DOLLARS)"
17/09/1996,CAD,1.3706,-0.02%,-0.0002,3.9,-1.5,42447,3806,4787,391,21576,29100,25773,34278,16674,8169,"(CONTRACTS OF 100,000 CANADIAN DOLLARS)"
10/09/1996,CAD,1.3703,-0.04%,-0.0004,3.87,-1.63,48902,3251,5477,383,29441,35158,33075,41018,15827,7884,"(CONTRACTS OF 100,000 CANADIAN DOLLARS)"
03/09/1996,CAD,1.3698,-0.12%,-0.0012,4,-1.37,50100,12759,4311,975,18571,37315,32305,42601,17795,7499,"(CONTRACTS OF 100,000 CANADIAN DOLLARS)"
27/08/1996,CAD,1.3681,0.40%,0.004,3.96,-1.5,43173,7408,2755,215,18680,32538,26303,35508,16870,7665,"(CONTRACTS OF 100,000 CANADIAN DOLLARS)"
20/08/1996,CAD,1.3736,0.03%,0.0003,3.87,-1.63,40733,3356,5860,1040,21136,23023,25532,29923,15201,10810,"(CONTRACTS OF 100,000 CANADIAN DOLLARS)"
13/08/1996,CAD,1.374,-0.05%,-0.0005,4.15,-1.34,39870,2891,7146,891,21462,22294,25244,30331,14626,9539,"(CONTRACTS OF 100,000 CANADIAN DOLLARS)"
06/08/1996,CAD,1.3733,0.05%,0.0005,4.28,-0.97,41519,3391,7848,1156,22867,22169,27414,31173,14105,10346,"(CONTRACTS OF 100,000 CANADIAN DOLLARS)"
30/07/1996,CAD,1.374,-0.19%,-0.0019,4.5,-0.84,39255,3038,7634,922,21903,20972,25863,29528,13392,9727,"(CONTRACTS OF 100,000 CANADIAN DOLLARS)"
23/07/1996,CAD,1.3714,-0.14%,-0.0014,4.5,-0.87,36777,4141,4920,1200,16961,22517,22302,28637,14475,8140,"(CONTRACTS OF 100,000 CANADIAN DOLLARS)"
16/07/1996,CAD,1.3695,-0.18%,-0.0018,4.68,-0.69,37383,5070,5202,931,16077,23406,22078,29539,15305,7844,"(CONTRACTS OF 100,000 CANADIAN DOLLARS)"
09/07/1996,CAD,1.367,-0.56%,-0.0056,4.68,-0.75,36736,4553,4247,1240,13866,22220,19659,27707,17077,9029,"(CONTRACTS OF 100,000 CANADIAN DOLLARS)"
02/07/1996,CAD,1.3594,-0.06%,-0.0006,4.62,-0.85,37716,10682,3193,690,8428,27367,19800,31250,17916,6466,"(CONTRACTS OF 100,000 CANADIAN DOLLARS)"
25/06/1996,CAD,1.3586,0.72%,0.0072,4.72,-0.81,34868,9863,1587,588,7191,26548,17642,28723,17226,6145,"(CONTRACTS OF 100,000 CANADIAN DOLLARS)"
18/06/1996,CAD,1.3684,-0.23%,-0.0023,4.78,-0.75,37261,3380,1852,631,17331,22648,21342,25131,15919,12130,"(CONTRACTS OF 100,000 CANADIAN DOLLARS)"
11/06/1996,CAD,1.3652,0.20%,0.002,4.75,-0.69,39445,4068,1852,1516,16859,27842,22443,31210,17002,8235,"(CONTRACTS OF 100,000 CANADIAN DOLLARS)"
04/06/1996,CAD,1.3679,0.60%,0.006,4.75,-0.59,43947,2497,4929,1249,22738,25909,26484,32087,17463,11860,"(CONTRACTS OF 100,000 CANADIAN DOLLARS)"
28/05/1996,CAD,1.3762,-0.31%,-0.0031,4.5,-1,53866,2152,16331,599,37236,23775,39987,40705,13879,13161,"(CONTRACTS OF 100,000 CANADIAN DOLLARS)"
21/05/1996,CAD,1.372,-0.26%,-0.0026,4.66,-0.77,49808,2006,12885,599,31506,23176,34111,36660,15697,13148,"(CONTRACTS OF 100,000 CANADIAN DOLLARS)"
14/05/1996,CAD,1.3684,-0.33%,-0.0033,4.77,-0.6,46048,6807,6118,702,24628,28269,32137,35089,13911,10959,"(CONTRACTS OF 100,000 CANADIAN DOLLARS)"
07/05/1996,CAD,1.3639,-0.26%,-0.0026,4.74,-0.6,42265,8129,2388,990,18156,29931,27275,33309,14990,8956,"(CONTRACTS OF 100,000 CANADIAN DOLLARS)"
30/04/1996,CAD,1.3604,0.10%,0.001,4.68,-0.66,38673,8456,1800,559,14764,27591,23779,29950,14894,8723,"(CONTRACTS OF 100,000 CANADIAN DOLLARS)"
23/04/1996,CAD,1.3617,-0.24%,-0.0024,4.75,-0.5,39169,10240,413,324,11460,29086,22024,29823,17145,9346,"(CONTRACTS OF 100,000 CANADIAN DOLLARS)"
16/04/1996,CAD,1.3585,-0.01%,-0.0001,4.87,-0.5,41267,14176,413,518,6393,32546,21087,33477,20180,7790,"(CONTRACTS OF 100,000 CANADIAN DOLLARS)"
09/04/1996,CAD,1.3583,-0.26%,-0.0026,4.93,-0.44,41188,15828,702,514,5184,33639,21526,34855,19662,6333,"(CONTRACTS OF 100,000 CANADIAN DOLLARS)"
02/04/1996,CAD,1.3548,0.48%,0.0049,4.93,-0.5,45017,19173,494,649,5039,38110,24861,39253,20156,5764,"(CONTRACTS OF 100,000 CANADIAN DOLLARS)"
26/03/1996,CAD,1.3614,-0.24%,-0.0024,4.93,-0.35,38235,14125,673,558,6116,30816,20799,32047,17436,6188,"(CONTRACTS OF 100,000 CANADIAN DOLLARS)"
19/03/1996,CAD,1.3582,0.75%,0.0076,4.94,-0.49,47150,15039,798,303,11562,37805,26904,38906,20246,8244,"(CONTRACTS OF 100,000 CANADIAN DOLLARS)"
12/03/1996,CAD,1.3685,0.29%,0.0029,5.26,-0.05,37673,5019,1646,0,14816,27782,19835,29428,17838,8245,"(CONTRACTS OF 100,000 CANADIAN DOLLARS)"
05/03/1996,CAD,1.3725,0.13%,0.0013,5.07,-0.33,35854,3461,3418,459,15966,20528,19886,24405,15968,11449,"(CONTRACTS OF 100,000 CANADIAN DOLLARS)"
27/02/1996,CAD,1.3743,0.56%,0.0056,5.12,-0.16,36277,1835,5568,824,17786,18081,20445,24473,15832,11804,"(CONTRACTS OF 100,000 CANADIAN DOLLARS)"
20/02/1996,CAD,1.382,-0.71%,-0.0071,5.15,-0.14,39066,1961,7316,1184,20789,18271,23934,26771,15132,12295,"(CONTRACTS OF 100,000 CANADIAN DOLLARS)"
13/02/1996,CAD,1.3722,-0.01%,-0.0001,4.87,-0.29,35631,3032,3254,1464,15141,22825,19637,27543,15994,8088,"(CONTRACTS OF 100,000 CANADIAN DOLLARS)"
06/02/1996,CAD,1.372,0.37%,0.0037,5,-0.18,42313,3122,12850,1278,22660,16965,27060,31093,15253,11220,"(CONTRACTS OF 100,000 CANADIAN DOLLARS)"
30/01/1996,CAD,1.3771,-0.67%,-0.0067,5.12,-0.01,42912,1931,13423,1537,25979,16694,29447,31654,13465,11258,"(CONTRACTS OF 100,000 CANADIAN DOLLARS)"
23/01/1996,CAD,1.3679,0.01%,0.0001,5.5,0.41,29221,2330,1945,1553,11304,17273,15187,20771,14034,8450,"(CONTRACTS OF 100,000 CANADIAN DOLLARS)"
16/01/1996,CAD,1.3681,-0.50%,-0.005,5.43,0.25,28290,2897,823,1583,11005,16933,15485,19339,12805,8951,"(CONTRACTS OF 100,000 CANADIAN DOLLARS)"
09/01/1996,CAD,1.3613,-0.44%,-0.0043,5.38,0.2,27971,3179,846,1600,10016,18569,14795,21015,13176,6956,"(CONTRACTS OF 100,000 CANADIAN DOLLARS)"
02/01/1996,CAD,1.3554,0.32%,0.0032,5.37,0.1,29038,2938,1390,1781,11570,18150,16289,21321,12749,7717,"(CONTRACTS OF 100,000 CANADIAN DOLLARS)"
26/12/1995,CAD,1.3598,1.00%,0.01,5.56,0.31,27808,2885,1594,1771,11680,15920,16336,19285,11472,8523,"(CONTRACTS OF 100,000 CANADIAN DOLLARS)"
19/12/1995,CAD,1.3735,0.26%,0.0026,5.81,0.35,50078,2139,10463,2136,34130,26527,38405,39126,11673,10952,"(CONTRACTS OF 100,000 CANADIAN DOLLARS)"
12/12/1995,CAD,1.3771,-0.83%,-0.0082,5.85,0.39,51147,1993,10670,2380,33184,25947,37557,38997,13590,12150,"(CONTRACTS OF 100,000 CANADIAN DOLLARS)"
05/12/1995,CAD,1.3658,-0.75%,-0.0074,5.75,0.38,42909,3121,2467,1941,26020,32564,31082,36972,11827,5937,"(CONTRACTS OF 100,000 CANADIAN DOLLARS)"
28/11/1995,CAD,1.3557,-0.22%,-0.0022,5.68,0.18,41357,4281,0,1374,23323,31723,28978,33097,12379,8260,"(CONTRACTS OF 100,000 CANADIAN DOLLARS)"
21/11/1995,CAD,1.3527,-0.01%,-0.0001,5.87,0.24,40386,4213,270,1334,21752,32029,27299,33633,13087,6753,"(CONTRACTS OF 100,000 CANADIAN DOLLARS)"
14/11/1995,CAD,1.3526,0.32%,0.0032,5.75,0.1,39472,4174,302,1329,21656,29344,27159,30975,12313,8497,"(CONTRACTS OF 100,000 CANADIAN DOLLARS)"
07/11/1995,CAD,1.357,-0.97%,-0.0096,5.81,0.19,39221,4669,0,1162,20613,29848,26444,31010,12777,8211,"(CONTRACTS OF 100,000 CANADIAN DOLLARS)"
31/10/1995,CAD,1.344,1.68%,0.017,6,0.25,42519,4025,206,1018,22460,28169,27503,29393,15016,13126,"(CONTRACTS OF 100,000 CANADIAN DOLLARS)"
24/10/1995,CAD,1.367,-2.18%,-0.0216,7.15,1.47,42368,5274,4149,1635,21405,25258,28314,31042,14054,11326,"(CONTRACTS OF 100,000 CANADIAN DOLLARS)"
17/10/1995,CAD,1.3378,-0.25%,-0.0025,6.25,0.16,43870,11283,959,2198,13567,34949,27048,38106,16822,5764,"(CONTRACTS OF 100,000 CANADIAN DOLLARS)"
10/10/1995,CAD,1.3345,-0.34%,-0.0034,6.25,0.75,45203,11456,890,2034,13506,36398,26996,39322,18207,5881,"(CONTRACTS OF 100,000 CANADIAN DOLLARS)"
03/10/1995,CAD,1.33,1.14%,0.0114,6.12,0.31,43581,9968,820,1254,15311,34760,26533,36834,17048,6747,"(CONTRACTS OF 100,000 CANADIAN DOLLARS)"
26/09/1995,CAD,1.3453,1.01%,0.0101,6.31,0.61,33153,3485,811,1242,17339,24874,22066,26927,11087,6226,"(CONTRACTS OF 100,000 CANADIAN DOLLARS)"
19/09/1995,CAD,1.359,-0.88%,-0.0088,6.68,0.93,50826,3743,2069,1409,32558,35139,37710,38617,13116,12209,"(CONTRACTS OF 100,000 CANADIAN DOLLARS)"
12/09/1995,CAD,1.3471,-0.45%,-0.0045,6.43,0.71,74047,24088,469,2249,22216,58755,48553,61473,25494,12574,"(CONTRACTS OF 100,000 CANADIAN DOLLARS)"
05/09/1995,CAD,1.341,-0.02%,-0.0002,6.18,0.4,59686,26814,1115,3352,9480,48538,39646,53005,20040,6681,"(CONTRACTS OF 100,000 CANADIAN DOLLARS)"
29/08/1995,CAD,1.3407,1.13%,0.0113,6.28,0.6,57983,25489,1296,3060,8943,47463,37492,51819,20491,6164,"(CONTRACTS OF 100,000 CANADIAN DOLLARS)"
22/08/1995,CAD,1.356,0.16%,0.0016,6.25,0.59,38582,12601,671,2770,10034,29182,25405,32623,13177,5959,"(CONTRACTS OF 100,000 CANADIAN DOLLARS)"
15/08/1995,CAD,1.3582,0.04%,0.0004,6.56,0.75,38040,11661,1185,2777,10383,28578,24821,32540,13219,5500,"(CONTRACTS OF 100,000 CANADIAN DOLLARS)"
08/08/1995,CAD,1.3587,0.64%,0.0065,6.5,0.82,38822,12387,688,2546,9812,30376,24745,33610,14077,5212,"(CONTRACTS OF 100,000 CANADIAN DOLLARS)"
01/08/1995,CAD,1.3675,-0.89%,-0.0088,6.75,1,39597,11390,271,2689,10744,29504,24823,32464,14774,7133,"(CONTRACTS OF 100,000 CANADIAN DOLLARS)"
25/07/1995,CAD,1.3555,0.32%,0.0032,6.56,0.85,46023,17163,769,2790,8161,37241,28114,40800,17909,5223,"(CONTRACTS OF 100,000 CANADIAN DOLLARS)"
18/07/1995,CAD,1.3598,-0.61%,-0.0061,6.37,0.66,49312,19117,2397,2743,8372,39157,30232,44297,19080,5015,"(CONTRACTS OF 100,000 CANADIAN DOLLARS)"
11/07/1995,CAD,1.3515,1.46%,0.0147,6.37,0.62,50369,20092,2953,2515,7927,39746,30534,45214,19835,5155,"(CONTRACTS OF 100,000 CANADIAN DOLLARS)"
03/07/1995,CAD,1.3715,0.17%,0.0017,6.56,0.81,34118,8620,1992,2538,8817,24564,19975,29094,14143,5024,"(CONTRACTS OF 100,000 CANADIAN DOLLARS)"
27/06/1995,CAD,1.3738,0.38%,0.0038,6.62,0.81,33533,8189,2072,2509,8558,23488,19256,28069,14277,5464,"(CONTRACTS OF 100,000 CANADIAN DOLLARS)"
20/06/1995,CAD,1.379,0.23%,0.0023,6.62,0.97,36466,6720,2367,2496,13428,21312,22644,26175,13822,10291,"(CONTRACTS OF 100,000 CANADIAN DOLLARS)"
13/06/1995,CAD,1.3822,-0.07%,-0.0007,6.93,1.25,40815,5414,3459,3242,15799,22590,24455,29291,16360,11524,"(CONTRACTS OF 100,000 CANADIAN DOLLARS)"
06/06/1995,CAD,1.3812,-0.71%,-0.007,7.06,1.13,39995,6761,2034,4653,15671,23138,27085,29825,12910,10170,"(CONTRACTS OF 100,000 CANADIAN DOLLARS)"
30/05/1995,CAD,1.3715,-0.59%,-0.0059,7.31,1.56,40885,9787,1747,3137,11942,26742,24866,31626,16019,9259,"(CONTRACTS OF 100,000 CANADIAN DOLLARS)"
23/05/1995,CAD,1.3635,-0.72%,-0.0071,7.18,1.31,45027,14333,1078,3004,12063,32883,29400,36965,15627,8062,"(CONTRACTS OF 100,000 CANADIAN DOLLARS)"
16/05/1995,CAD,1.3538,0.31%,0.0031,7.25,1.44,48219,16528,855,3085,10824,37733,30437,41673,17782,6546,"(CONTRACTS OF 100,000 CANADIAN DOLLARS)"
09/05/1995,CAD,1.358,-0.01%,-0.0001,7.12,1.37,50968,18047,1267,3272,11178,40805,32497,45344,18471,5624,"(CONTRACTS OF 100,000 CANADIAN DOLLARS)"
02/05/1995,CAD,1.3579,0.46%,0.0046,7.5,1.66,50828,17798,651,2268,11294,42763,31360,45682,19468,5146,"(CONTRACTS OF 100,000 CANADIAN DOLLARS)"
25/04/1995,CAD,1.3642,0.42%,0.0042,7.62,1.62,50031,17160,612,2125,11458,41223,30743,43960,19288,6071,"(CONTRACTS OF 100,000 CANADIAN DOLLARS)"
18/04/1995,CAD,1.37,0.98%,0.0098,7.81,1.75,48540,17049,616,2479,10490,40428,30018,43523,18522,5017,"(CONTRACTS OF 100,000 CANADIAN DOLLARS)"
11/04/1995,CAD,1.3835,0.61%,0.0061,7.75,1.72,46365,16453,2040,2777,10107,35979,29337,40796,17028,5569,"(CONTRACTS OF 100,000 CANADIAN DOLLARS)"
04/04/1995,CAD,1.392,0.73%,0.0074,8.18,2.11,33239,7804,1433,2506,10237,23405,20547,27344,12692,5895,"(CONTRACTS OF 100,000 CANADIAN DOLLARS)"
28/03/1995,CAD,1.4023,-0.01%,-0.0001,8.06,2.04,27263,4203,2216,1679,10693,15580,16575,19475,10688,7788,"(CONTRACTS OF 100,000 CANADIAN DOLLARS)"
21/03/1995,CAD,1.4022,0.76%,0.0077,8,1.94,27462,4295,2977,1725,10639,14612,16659,19314,10803,8148,"(CONTRACTS OF 100,000 CANADIAN DOLLARS)"
14/03/1995,CAD,1.413,0.11%,0.0011,7.81,1.69,38084,2755,4804,1721,19636,17221,24112,23746,13972,14338,"(CONTRACTS OF 100,000 CANADIAN DOLLARS)"
07/03/1995,CAD,1.4145,-1.80%,-0.0178,8.23,2.08,44087,4388,5008,1702,23671,22925,29761,29635,14326,14452,"(CONTRACTS OF 100,000 CANADIAN DOLLARS)"
28/02/1995,CAD,1.3895,0.84%,0.0085,7.5,1.38,42646,3401,2713,2933,21473,27095,27807,32741,14839,9905,"(CONTRACTS OF 100,000 CANADIAN DOLLARS)"
21/02/1995,CAD,1.4013,0.01%,0.0001,8,1.88,43565,4837,3947,3178,21357,26949,29372,34074,14193,9491,"(CONTRACTS OF 100,000 CANADIAN DOLLARS)"
14/02/1995,CAD,1.4015,-0.39%,-0.0039,7.87,1.75,43238,4379,4611,3157,21743,25263,29279,33031,13959,10207,"(CONTRACTS OF 100,000 CANADIAN DOLLARS)"
07/02/1995,CAD,1.396,0.78%,0.0078,7.68,1.56,46674,3220,8658,3084,24759,23587,31063,35329,15611,11345,"(CONTRACTS OF 100,000 CANADIAN DOLLARS)"
31/01/1995,CAD,1.407,0.53%,0.0053,8.06,1.94,52723,3790,21491,3209,32547,15216,39546,39916,13177,12807,"(CONTRACTS OF 100,000 CANADIAN DOLLARS)"
24/01/1995,CAD,1.4145,0.30%,0.003,8,2,56213,2877,25515,2893,38129,13233,43899,41641,12314,14572,"(CONTRACTS OF 100,000 CANADIAN DOLLARS)"
17/01/1995,CAD,1.4187,-0.63%,-0.0063,7.75,1.66,55051,2428,26577,3080,37663,10656,43171,40313,11880,14738,"(CONTRACTS OF 100,000 CANADIAN DOLLARS)"
10/01/1995,CAD,1.4098,-0.31%,-0.0031,6.81,0.61,56636,1683,28432,2422,42229,9903,46334,40757,10302,15879,"(CONTRACTS OF 100,000 CANADIAN DOLLARS)"
03/01/1995,CAD,1.4054,-0.31%,-0.0031,6.62,0.56,54732,1078,28273,2413,42696,9860,46187,40546,8545,14186,"(CONTRACTS OF 100,000 CANADIAN DOLLARS)"
27/12/1994,CAD,1.401,-0.52%,-0.0052,6.62,0.5,51589,1297,26154,2192,39908,9317,43397,37663,8192,13926,"(CONTRACTS OF 100,000 CANADIAN DOLLARS)"
20/12/1994,CAD,1.3937,-0.47%,-0.0047,6.68,0.68,67155,1431,25875,2108,47728,25077,51267,53060,15888,14095,"(CONTRACTS OF 100,000 CANADIAN DOLLARS)"
13/12/1994,CAD,1.3872,-1.01%,-0.0101,6.62,0.31,67004,1927,24792,2068,52336,25833,56331,52693,10673,14311,"(CONTRACTS OF 100,000 CANADIAN DOLLARS)"
06/12/1994,CAD,1.3733,0.38%,0.0038,5.93,-0.44,55343,1949,19523,3044,37229,17024,42222,39591,13121,15752,"(CONTRACTS OF 100,000 CANADIAN DOLLARS)"
29/11/1994,CAD,1.3785,-0.36%,-0.0036,5.75,-0.43,54462,1287,21513,3345,37099,14821,41731,39679,12731,14783,"(CONTRACTS OF 100,000 CANADIAN DOLLARS)"
22/11/1994,CAD,1.3736,-0.74%,-0.0074,5.5,-0.56,46293,1605,18638,2684,32095,15079,36384,36401,9909,9892,"(CONTRACTS OF 100,000 CANADIAN DOLLARS)"
15/11/1994,CAD,1.3635,-0.54%,-0.0054,5.5,-0.75,39735,2581,10233,2251,21196,17726,26028,30210,13707,9525,"(CONTRACTS OF 100,000 CANADIAN DOLLARS)"
08/11/1994,CAD,1.3562,0.01%,0.0001,5.37,-0.75,37841,6597,10431,1849,16370,18181,24816,30461,13025,7380,"(CONTRACTS OF 100,000 CANADIAN DOLLARS)"
01/11/1994,CAD,1.3564,-0.60%,-0.006,5.37,-0.44,38858,8307,7927,1998,15807,19954,26112,29879,12746,8979,"(CONTRACTS OF 100,000 CANADIAN DOLLARS)"
25/10/1994,CAD,1.3483,0.39%,0.0039,5.12,-0.75,38021,10227,6634,1436,12099,22541,23762,30611,14259,7410,"(CONTRACTS OF 100,000 CANADIAN DOLLARS)"
18/10/1994,CAD,1.3536,-0.71%,-0.0071,5.31,-0.25,37850,9963,8948,1266,13876,20093,25105,30307,12745,7543,"(CONTRACTS OF 100,000 CANADIAN DOLLARS)"
11/10/1994,CAD,1.344,0.04%,0.0004,5.25,-0.31,44573,22691,4306,893,3997,33119,27581,38318,16992,6255,"(CONTRACTS OF 100,000 CANADIAN DOLLARS)"
04/10/1994,CAD,1.3445,0.04%,0.0004,5.18,-0.38,46240,24047,4324,955,4124,35007,29126,40286,17114,5954,"(CONTRACTS OF 100,000 CANADIAN DOLLARS)"
27/09/1994,CAD,1.345,-0.29%,-0.0029,5,-0.44,45915,23812,3663,900,4216,34730,28928,39293,16987,6622,"(CONTRACTS OF 100,000 CANADIAN DOLLARS)"
20/09/1994,CAD,1.3411,0.47%,0.0048,5.21,-0.22,54681,25203,4185,751,4760,35996,30714,40932,23967,13749,"(CONTRACTS OF 100,000 CANADIAN DOLLARS)"
13/09/1994,CAD,1.3475,1.46%,0.0147,5.25,-0.28,51441,23139,7107,1145,9957,34418,34241,42670,17200,8771,"(CONTRACTS OF 100,000 CANADIAN DOLLARS)"
06/09/1994,CAD,1.3675,0.04%,0.0004,5.68,0.33,51099,15148,8607,1038,10491,25982,26677,35627,24422,15472,"(CONTRACTS OF 100,000 CANADIAN DOLLARS)"
30/08/1994,CAD,1.368,0.59%,0.0059,5.37,0.25,44063,16604,8327,1568,9259,26443,27431,36338,16632,7725,"(CONTRACTS OF 100,000 CANADIAN DOLLARS)"
23/08/1994,CAD,1.3761,0.10%,0.001,5.25,0.38,39309,13359,7104,1512,10023,22670,24894,31286,14415,8023,"(CONTRACTS OF 100,000 CANADIAN DOLLARS)"
16/08/1994,CAD,1.3775,-0.40%,-0.004,5.5,0.69,39964,14059,5587,2135,9042,23958,25236,31680,14728,8284,"(CONTRACTS OF 100,000 CANADIAN DOLLARS)"
09/08/1994,CAD,1.372,1.19%,0.012,5.5,0.64,40216,13641,4706,1416,8347,22919,23404,29041,16812,11175,"(CONTRACTS OF 100,000 CANADIAN DOLLARS)"
02/08/1994,CAD,1.3885,-0.69%,-0.0069,5.56,0.81,34259,6208,8332,2132,15268,12944,23608,23408,10651,10851,"(CONTRACTS OF 100,000 CANADIAN DOLLARS)"
26/07/1994,CAD,1.379,-0.22%,-0.0022,5.87,0.94,35599,12736,5748,1894,7941,18938,22571,26580,13028,9019,"(CONTRACTS OF 100,000 CANADIAN DOLLARS)"
19/07/1994,CAD,1.376,0.53%,0.0053,5.87,1.06,34927,11618,5969,2228,8035,17260,21881,25457,13046,9470,"(CONTRACTS OF 100,000 CANADIAN DOLLARS)"
12/07/1994,CAD,1.3833,0.19%,0.0019,6.25,1.63,36327,10157,9705,2348,11898,13819,24403,25872,11924,10455,"(CONTRACTS OF 100,000 CANADIAN DOLLARS)"
05/07/1994,CAD,1.3859,-0.17%,-0.0017,6.31,1.58,36536,11239,8792,2322,10809,14406,24370,25520,12166,11016,"(CONTRACTS OF 100,000 CANADIAN DOLLARS)"
28/06/1994,CAD,1.3835,0.14%,0.0014,6.5,1.86,40351,10094,14039,2405,16845,11436,29344,27880,11007,12471,"(CONTRACTS OF 100,000 CANADIAN DOLLARS)"
21/06/1994,CAD,1.3855,-0.07%,-0.0007,6.62,2.06,40447,10098,14915,1661,17185,11550,28944,28126,11503,12321,"(CONTRACTS OF 100,000 CANADIAN DOLLARS)"
14/06/1994,CAD,1.3845,-0.80%,-0.008,6,1.32,43074,6221,5835,1809,20423,20035,28453,27679,14621,15395,"(CONTRACTS OF 100,000 CANADIAN DOLLARS)"
07/06/1994,CAD,1.3735,0.67%,0.0067,5.87,1.19,49293,6811,4643,1447,20580,29205,28838,35295,20455,13998,"(CONTRACTS OF 100,000 CANADIAN DOLLARS)"
31/05/1994,CAD,1.3828,-0.34%,-0.0034,6.12,1.69,45427,3317,9217,1408,26264,21495,30989,32120,14438,13307,"(CONTRACTS OF 100,000 CANADIAN DOLLARS)"
24/05/1994,CAD,1.3781,-0.15%,-0.0015,6,1.69,45144,2965,10300,2131,25186,19698,30282,32129,14862,13015,"(CONTRACTS OF 100,000 CANADIAN DOLLARS)"
17/05/1994,CAD,1.376,0.14%,0.0014,6.06,1.65,42898,4918,9057,1701,21257,19613,27876,30371,15022,12527,"(CONTRACTS OF 100,000 CANADIAN DOLLARS)"
10/05/1994,CAD,1.3779,0.68%,0.0069,6.25,1.81,43990,6231,8636,1739,21708,21035,29678,31410,14312,12580,"(CONTRACTS OF 100,000 CANADIAN DOLLARS)"
03/05/1994,CAD,1.3874,-1.09%,-0.0108,5.87,1.43,43915,5084,11511,1780,22883,18591,29747,31882,14168,12033,"(CONTRACTS OF 100,000 CANADIAN DOLLARS)"
26/04/1994,CAD,1.3725,0.80%,0.008,5.75,1.32,41747,5297,9734,1671,21414,18900,28382,30305,13365,11442,"(CONTRACTS OF 100,000 CANADIAN DOLLARS)"
19/04/1994,CAD,1.3835,-0.47%,-0.0047,6,1.32,42749,5654,12015,1660,23454,15295,30768,28970,11981,13779,"(CONTRACTS OF 100,000 CANADIAN DOLLARS)"
12/04/1994,CAD,1.377,0.44%,0.0044,5.56,1.14,43423,4976,13943,1452,24951,14200,31379,29595,12044,13828,"(CONTRACTS OF 100,000 CANADIAN DOLLARS)"
05/04/1994,CAD,1.3831,-0.49%,-0.0049,5.87,1.62,43576,2764,14394,1252,25525,14515,29541,30161,14035,13415,"(CONTRACTS OF 100,000 CANADIAN DOLLARS)"
29/03/1994,CAD,1.3764,-0.72%,-0.0071,5.12,1.06,44543,4746,14761,1009,24766,15754,30521,31524,14022,13019,"(CONTRACTS OF 100,000 CANADIAN DOLLARS)"
22/03/1994,CAD,1.3666,-0.19%,-0.0019,4.56,0.69,43654,4529,12661,866,26173,17416,31568,30943,12086,12711,"(CONTRACTS OF 100,000 CANADIAN DOLLARS)"
15/03/1994,CAD,1.364,-0.62%,-0.0062,3.87,0,56396,4374,13921,491,28670,17667,33535,32079,22861,24317,"(CONTRACTS OF 100,000 CANADIAN DOLLARS)"
08/03/1994,CAD,1.3556,-0.43%,-0.0043,3.87,0.03,52577,3702,13102,526,32558,21000,36786,34628,15791,17949,"(CONTRACTS OF 100,000 CANADIAN DOLLARS)"
01/03/1994,CAD,1.3498,-0.93%,-0.0093,3.68,0,46975,4021,11012,1000,26901,18002,31922,30014,15053,16961,"(CONTRACTS OF 100,000 CANADIAN DOLLARS)"
22/02/1994,CAD,1.3373,1.09%,0.0109,3.62,-0.06,41548,5012,9258,1351,22640,17214,29003,27823,12545,13725,"(CONTRACTS OF 100,000 CANADIAN DOLLARS)"
15/02/1994,CAD,1.352,-0.72%,-0.0071,3.56,-0.19,41220,3653,8850,1213,23789,16359,28655,26422,12565,14798,"(CONTRACTS OF 100,000 CANADIAN DOLLARS)"
08/02/1994,CAD,1.3424,-0.89%,-0.0088,3.62,-0.06,35365,3647,5124,921,19840,17295,24408,23340,10957,12025,"(CONTRACTS OF 100,000 CANADIAN DOLLARS)"
01/02/1994,CAD,1.3306,-1.42%,-0.0141,3.43,-0.19,29112,4939,1085,729,11136,16974,16804,18788,12308,10324,"(CONTRACTS OF 100,000 CANADIAN DOLLARS)"
25/01/1994,CAD,1.312,0.10%,0.001,3.56,0.25,28554,8127,1176,506,4641,18103,13274,19785,15280,8769,"(CONTRACTS OF 100,000 CANADIAN DOLLARS)"
18/01/1994,CAD,1.3133,0.62%,0.0062,3.62,0.25,27523,6190,1512,1150,6078,16745,13418,19407,14105,8116,"(CONTRACTS OF 100,000 CANADIAN DOLLARS)"
11/01/1994,CAD,1.3215,-0.38%,-0.0038,3.62,0.31,27694,6906,1077,1158,5849,16283,13913,18518,13781,9176,"(CONTRACTS OF 100,000 CANADIAN DOLLARS)"
04/01/1994,CAD,1.3165,1.07%,0.0108,3.68,0.56,28295,8240,868,1128,6178,16519,15546,18515,12749,9780,"(CONTRACTS OF 100,000 CANADIAN DOLLARS)"
28/12/1993,CAD,1.3308,0.98%,0.0099,3.81,0.56,24332,3031,2329,1153,10831,11554,15015,15036,9317,9296,"(CONTRACTS OF 100,000 CANADIAN DOLLARS)"
21/12/1993,CAD,1.344,-0.79%,-0.0078,3.87,0.75,29211,3169,5258,1152,16879,9467,21200,15877,8011,13334,"(CONTRACTS OF 100,000 CANADIAN DOLLARS)"
14/12/1993,CAD,1.3335,-0.82%,-0.0081,3.93,0.75,31438,2839,3975,1173,19017,15345,23029,20493,8409,10945,"(CONTRACTS OF 100,000 CANADIAN DOLLARS)"
07/12/1993,CAD,1.3227,1.00%,0.0101,3.87,0.64,31913,3380,2598,1209,16981,16068,21570,19875,10343,12038,"(CONTRACTS OF 100,000 CANADIAN DOLLARS)"
30/11/1993,CAD,1.3361,-0.74%,-0.0074,3.93,0.68,34373,3420,4258,1144,20543,16641,25107,22043,9266,12330,"(CONTRACTS OF 100,000 CANADIAN DOLLARS)"
23/11/1993,CAD,1.3263,-1.09%,-0.0108,4,0.79,31538,3309,2220,1551,16874,16652,21734,20423,9804,11115,"(CONTRACTS OF 100,000 CANADIAN DOLLARS)"
16/11/1993,CAD,1.312,-0.51%,-0.0051,4.12,0.87,29633,2585,4072,1518,14019,13996,18122,19586,11511,10047,"(CONTRACTS OF 100,000 CANADIAN DOLLARS)"
09/11/1993,CAD,1.3053,0.15%,0.0015,4.18,0.81,34602,9698,4253,819,9703,21210,20220,26282,14382,8320,"(CONTRACTS OF 100,000 CANADIAN DOLLARS)"
02/11/1993,CAD,1.3072,0.69%,0.0069,4.31,1,33472,8606,3636,814,10768,19416,20188,23866,13284,9606,"(CONTRACTS OF 100,000 CANADIAN DOLLARS)"
26/10/1993,CAD,1.3163,0.65%,0.0065,4.43,1.12,33188,7644,3566,828,13684,19594,22156,23988,11032,9200,"(CONTRACTS OF 100,000 CANADIAN DOLLARS)"
19/10/1993,CAD,1.3249,0.36%,0.0036,4.5,1.13,45072,4261,15152,776,32502,14315,37539,30243,7533,14829,"(CONTRACTS OF 100,000 CANADIAN DOLLARS)"
12/10/1993,CAD,1.3297,0.47%,0.0047,4.43,1.06,49915,4434,18928,488,37359,13289,42281,32705,7634,17210,"(CONTRACTS OF 100,000 CANADIAN DOLLARS)"
05/10/1993,CAD,1.336,-1.00%,-0.0099,4.56,1.25,50423,4036,20576,488,38663,11482,43187,32546,7236,17877,"(CONTRACTS OF 100,000 CANADIAN DOLLARS)"
28/09/1993,CAD,1.3228,-0.23%,-0.0023,4.56,1.31,36772,3758,12004,700,24579,10175,29037,22879,7735,13893,"(CONTRACTS OF 100,000 CANADIAN DOLLARS)"
21/09/1993,CAD,1.3198,0.17%,0.0017,4.56,1.35,34773,3088,9587,1033,21597,11552,25718,22172,9055,12601,"(CONTRACTS OF 100,000 CANADIAN DOLLARS)"
14/09/1993,CAD,1.3221,-0.16%,-0.0016,4.75,1.53,44869,2403,12731,1265,34223,13307,37891,27303,6978,17566,"(CONTRACTS OF 100,000 CANADIAN DOLLARS)"
07/09/1993,CAD,1.32,-0.08%,-0.0008,4.62,1.4,46780,2157,17639,1268,34322,10247,37747,29154,9033,17626,"(CONTRACTS OF 100,000 CANADIAN DOLLARS)"
31/08/1993,CAD,1.319,-0.07%,-0.0007,4.56,1.5,45243,1965,17809,2157,33507,9517,37629,29483,7614,15760,"(CONTRACTS OF 100,000 CANADIAN DOLLARS)"
24/08/1993,CAD,1.3181,-0.24%,-0.0024,4.62,1.56,46154,398,18726,2123,36352,9595,38873,30444,7281,15710,"(CONTRACTS OF 100,000 CANADIAN DOLLARS)"
17/08/1993,CAD,1.315,-1.69%,-0.0168,4.12,1.06,48848,353,18955,1343,38945,11466,40641,31764,8207,17084,"(CONTRACTS OF 100,000 CANADIAN DOLLARS)"
10/08/1993,CAD,1.2931,-0.29%,-0.0029,3.75,0.63,43458,311,13195,1194,34006,13263,35511,27652,7947,15806,"(CONTRACTS OF 100,000 CANADIAN DOLLARS)"
03/08/1993,CAD,1.2893,-0.49%,-0.0049,4,0.92,40502,346,11125,1302,32061,12979,33709,25406,6793,15096,"(CONTRACTS OF 100,000 CANADIAN DOLLARS)"
27/07/1993,CAD,1.283,-0.42%,-0.0042,3.93,0.81,28857,2133,4129,1176,16754,12963,20063,18268,8794,10589,"(CONTRACTS OF 100,000 CANADIAN DOLLARS)"
20/07/1993,CAD,1.2776,0.27%,0.0027,3.93,0.81,28579,3237,2823,1085,14391,13376,18713,17284,9866,11295,"(CONTRACTS OF 100,000 CANADIAN DOLLARS)"
13/07/1993,CAD,1.281,0.21%,0.0021,4.25,1.07,29175,2142,4351,1021,16362,11234,19525,16606,9650,12569,"(CONTRACTS OF 100,000 CANADIAN DOLLARS)"
06/07/1993,CAD,1.2837,-0.13%,-0.0013,4.31,1.19,31644,1722,7383,704,21429,8020,23855,16107,7789,15537,"(CONTRACTS OF 100,000 CANADIAN DOLLARS)"
29/06/1993,CAD,1.282,-0.34%,-0.0034,4.31,1.19,27008,1561,4459,632,16746,8199,18939,13290,8069,13718,"(CONTRACTS OF 100,000 CANADIAN DOLLARS)"
22/06/1993,CAD,1.2776,0.17%,0.0017,4.37,1.25,26335,2138,4566,632,15736,8238,18506,13436,7829,12899,"(CONTRACTS OF 100,000 CANADIAN DOLLARS)"
15/06/1993,CAD,1.2798,0.18%,0.0018,4.43,1.25,37502,336,7404,1305,29406,13303,31047,22012,6455,15490,"(CONTRACTS OF 100,000 CANADIAN DOLLARS)"
08/06/1993,CAD,1.2821,-0.85%,-0.0085,4.87,1.69,37449,627,7064,2493,26933,12136,30053,21693,7396,15756,"(CONTRACTS OF 100,000 CANADIAN DOLLARS)"
01/06/1993,CAD,1.2713,-0.86%,-0.0085,4.81,1.63,24302,1236,2323,1961,12080,8840,15277,13124,9025,11178,"(CONTRACTS OF 100,000 CANADIAN DOLLARS)"
25/05/1993,CAD,1.2605,0.58%,0.0059,4.62,1.47,22414,1968,2081,1719,9259,10299,12946,14099,9468,8315,"(CONTRACTS OF 100,000 CANADIAN DOLLARS)"
18/05/1993,CAD,1.2679,0.57%,0.0057,4.93,1.68,27440,1007,6537,1747,17597,6425,20351,14709,7089,12731,"(CONTRACTS OF 100,000 CANADIAN DOLLARS)"
11/05/1993,CAD,1.2752,-0.37%,-0.0037,4.84,1.66,29706,1221,8508,1767,20381,5771,23369,16046,6337,13660,"(CONTRACTS OF 100,000 CANADIAN DOLLARS)"
04/05/1993,CAD,1.2705,0.27%,0.0028,5,1.88,29784,1771,8211,1757,19159,6140,22687,16108,7097,13676,"(CONTRACTS OF 100,000 CANADIAN DOLLARS)"
27/04/1993,CAD,1.274,-1.56%,-0.0155,4.75,1.75,28933,2953,8468,1784,17601,6280,22338,16532,6595,12401,"(CONTRACTS OF 100,000 CANADIAN DOLLARS)"
20/04/1993,CAD,1.2544,0.52%,0.0052,4.81,1.78,22691,3327,5675,2026,9259,6373,14612,14074,8079,8617,"(CONTRACTS OF 100,000 CANADIAN DOLLARS)"
13/04/1993,CAD,1.261,-0.25%,-0.0025,4.81,1.88,22199,3710,4236,2019,8495,5717,14224,11972,7975,10227,"(CONTRACTS OF 100,000 CANADIAN DOLLARS)"
06/04/1993,CAD,1.2579,-0.62%,-0.0062,5.25,2.16,20678,4322,4016,1812,6874,5666,13008,11494,7670,9184,"(CONTRACTS OF 100,000 CANADIAN DOLLARS)"
30/03/1993,CAD,1.2501,-0.26%,-0.0026,4.81,1.69,21004,5368,3574,1177,4500,9117,11045,13868,9959,7136,"(CONTRACTS OF 100,000 CANADIAN DOLLARS)"
23/03/1993,CAD,1.2469,0.34%,0.0034,5.06,2,20880,7328,2202,1107,1360,11504,9795,14813,11085,6067,"(CONTRACTS OF 100,000 CANADIAN DOLLARS)"
16/03/1993,CAD,1.2512,-0.48%,-0.0048,5.18,2.06,30163,8872,1343,1441,4772,19612,15085,22396,15078,7767,"(CONTRACTS OF 100,000 CANADIAN DOLLARS)"
09/03/1993,CAD,1.2452,0.10%,0.001,5.25,2.13,31769,8642,1934,944,9009,20613,18595,23491,13174,8278,"(CONTRACTS OF 100,000 CANADIAN DOLLARS)"
02/03/1993,CAD,1.2465,0.52%,0.0052,5.5,2.38,27166,8566,1001,1554,4874,18073,14994,20628,12172,6538,"(CONTRACTS OF 100,000 CANADIAN DOLLARS)"
23/02/1993,CAD,1.253,0.40%,0.004,5.75,2.69,25332,7748,1581,1112,5608,15902,14468,18595,10864,6737,"(CONTRACTS OF 100,000 CANADIAN DOLLARS)"
16/02/1993,CAD,1.258,0.76%,0.0076,5.87,2.75,25911,7155,2216,1142,7078,15104,15375,18462,10536,7449,"(CONTRACTS OF 100,000 CANADIAN DOLLARS)"
09/02/1993,CAD,1.2676,-0.28%,-0.0028,5.87,2.81,23366,6608,2104,1122,6869,12234,14599,15460,8767,7906,"(CONTRACTS OF 100,000 CANADIAN DOLLARS)"
02/02/1993,CAD,1.2641,0.56%,0.0056,6.25,3.16,21708,5232,1354,1122,6328,12236,12682,14712,9026,6996,"(CONTRACTS OF 100,000 CANADIAN DOLLARS)"
26/01/1993,CAD,1.2712,0.54%,0.0054,6.37,3.31,19475,684,1831,1122,11617,8175,13423,11128,6052,8347,"(CONTRACTS OF 100,000 CANADIAN DOLLARS)"
19/01/1993,CAD,1.2781,-0.06%,-0.0006,6.37,3.25,20672,1618,1977,1124,11635,8794,14377,11895,6295,8777,"(CONTRACTS OF 100,000 CANADIAN DOLLARS)"
12/01/1993,CAD,1.2773,-0.09%,-0.0009,6.56,3.38,20715,1371,1377,1680,11633,9209,14684,12266,6031,8449,"(CONTRACTS OF 100,000 CANADIAN DOLLARS)"
05/01/1993,CAD,1.2761,-0.80%,-0.0079,6.87,3.87,20289,2113,1355,1649,10572,9429,14334,12433,5955,7856,"(CONTRACTS OF 100,000 CANADIAN DOLLARS)"
29/12/1992,CAD,1.266,-0.33%,-0.0033,6.62,3.62,19632,2700,1294,1619,8839,10242,13158,13155,6474,6477,"(CONTRACTS OF 100,000 CANADIAN DOLLARS)"
22/12/1992,CAD,1.2618,1.33%,0.0134,6.87,3.87,18042,1155,1418,1633,9852,8131,12640,11182,5402,6860,"(CONTRACTS OF 100,000 CANADIAN DOLLARS)"
15/12/1992,CAD,1.2788,-0.57%,-0.0056,7.31,4,30053,420,4653,1514,22155,12389,24089,18556,5964,11497,"(CONTRACTS OF 100,000 CANADIAN DOLLARS)"
08/12/1992,CAD,1.2716,0.77%,0.0078,7.31,4,28270,370,5275,1523,19877,8109,21770,14907,6500,13363,"(CONTRACTS OF 100,000 CANADIAN DOLLARS)"
01/12/1992,CAD,1.2815,0.38%,0.0038,7.88,4.51,31410,658,7965,1616,22290,7444,24564,17025,6846,14385,"(CONTRACTS OF 100,000 CANADIAN DOLLARS)"
24/11/1992,CAD,1.2864,-0.97%,-0.0097,8.18,4.31,31439,2041,7661,1460,21511,7893,25012,17014,6427,14425,"(CONTRACTS OF 100,000 CANADIAN DOLLARS)"
17/11/1992,CAD,1.274,-0.79%,-0.0079,7.75,4.25,29834,1106,6483,1748,20285,7272,23139,15503,6695,14331,"(CONTRACTS OF 100,000 CANADIAN DOLLARS)"
10/11/1992,CAD,1.264,-1.75%,-0.0173,6.5,2.75,25486,758,5643,2011,16085,6663,18854,14317,6632,11169,"(CONTRACTS OF 100,000 CANADIAN DOLLARS)"
03/11/1992,CAD,1.2423,-0.55%,-0.0055,5.81,2,23862,1527,5930,1945,12572,7101,16044,14976,7818,8886,"(CONTRACTS OF 100,000 CANADIAN DOLLARS)"
27/10/1992,CAD,1.2355,0.26%,0.0026,6,2.32,25623,1158,7086,2110,15235,7567,18503,16763,7120,8860,"(CONTRACTS OF 100,000 CANADIAN DOLLARS)"
20/10/1992,CAD,1.2387,0.36%,0.0036,7,3.38,27811,1532,7455,2137,17362,7091,21031,16683,6780,11128,"(CONTRACTS OF 100,000 CANADIAN DOLLARS)"
13/10/1992,CAD,1.2432,0.16%,0.0016,7.06,3.69,28345,370,8871,1982,20049,5839,22401,16692,5944,11653,"(CONTRACTS OF 100,000 CANADIAN DOLLARS)"
06/10/1992,CAD,1.2452,-0.02%,-0.0002,7.37,3.93,29787,630,10639,1870,21578,4945,24078,17454,5709,12333,"(CONTRACTS OF 100,000 CANADIAN DOLLARS)"
30/09/1992,CAD,1.245,-0.35%,-0.0035,7,3.57,28128,1474,11090,1855,19150,4033,22479,16978,5649,11150,"(CONTRACTS OF 100,000 CANADIAN DOLLARS)"
30/12/2008,CHF,1.0578,3.25%,0.033,0.71,-0.85,25073,4968,8815,300,6491,10305,11759,19420,13314,5653,"(CONTRACTS OF CHF 125,000)"
22/12/2008,CHF,1.0933,2.32%,0.0235,0.97,-0.77,24773,4310,8466,305,6309,9244,10924,18015,13849,6758,"(CONTRACTS OF CHF 125,000)"
16/12/2008,CHF,1.1193,7.17%,0.0744,0.81,-1.01,20142,1826,7137,365,4984,3219,7175,10721,12967,9421,"(CONTRACTS OF CHF 125,000)"
09/12/2008,CHF,1.2057,0.07%,0.0007,0.71,-1.34,38990,1620,15694,455,26924,7829,28999,23978,9991,15012,"(CONTRACTS OF CHF 125,000)"
02/12/2008,CHF,1.2065,-1.92%,-0.019,0.9,-2.43,42123,2328,20568,1415,29313,6752,33056,28735,9067,13388,"(CONTRACTS OF CHF 125,000)"
25/11/2008,CHF,1.1838,1.48%,0.0149,1.39,-2.05,42747,3653,20066,1052,27944,5769,32649,26887,10098,15860,"(CONTRACTS OF CHF 125,000)"
18/11/2008,CHF,1.2016,-1.19%,-0.0118,1.94,-0.33,43937,5740,19329,571,25109,6737,31420,26637,12517,17300,"(CONTRACTS OF CHF 125,000)"
11/11/2008,CHF,1.1875,-2.42%,-0.0239,2,-0.42,39893,4826,14982,505,25049,9713,30380,25200,9513,14693,"(CONTRACTS OF CHF 125,000)"
04/11/2008,CHF,1.1594,-0.27%,-0.0027,2.65,0.33,41403,7416,14617,501,22917,11945,30834,27063,10569,14340,"(CONTRACTS OF CHF 125,000)"
28/10/2008,CHF,1.1563,-0.36%,-0.0036,3.1,-0.47,39184,5726,20042,802,22738,4946,29266,25790,9918,13394,"(CONTRACTS OF CHF 125,000)"
21/10/2008,CHF,1.1522,-1.42%,-0.0141,3.14,-0.36,39838,3953,19875,241,24900,5372,29094,25488,10744,14350,"(CONTRACTS OF CHF 125,000)"
14/10/2008,CHF,1.1361,0.20%,0.002,3.53,-0.95,38302,5222,18304,69,23178,9912,28469,28285,9833,10017,"(CONTRACTS OF CHF 125,000)"
07/10/2008,CHF,1.1384,-1.54%,-0.0153,3.06,-1.64,39137,8291,19820,62,20398,8129,28751,28011,10386,11126,"(CONTRACTS OF CHF 125,000)"
30/09/2008,CHF,1.1211,-3.18%,-0.0313,2.7,-1.63,39047,5953,17402,288,20222,8058,26463,25748,12584,13299,"(CONTRACTS OF CHF 125,000)"
23/09/2008,CHF,1.0866,3.18%,0.0323,2.68,-1.4,42296,8345,16452,70,20616,14043,29031,30565,13265,11731,"(CONTRACTS OF CHF 125,000)"
16/09/2008,CHF,1.1223,0.31%,0.0031,2.65,-0.07,39036,7451,20899,17,21918,2559,29386,23475,9650,15561,"(CONTRACTS OF CHF 125,000)"
09/09/2008,CHF,1.1258,-1.77%,-0.0176,2.61,-0.24,70332,11076,25991,0,47387,26934,58463,52925,11869,17407,"(CONTRACTS OF CHF 125,000)"
02/09/2008,CHF,1.1062,-0.64%,-0.0063,2.61,-0.25,64084,12059,25322,13,40707,22659,52779,47994,11305,16090,"(CONTRACTS OF CHF 125,000)"
26/08/2008,CHF,1.0992,-0.75%,-0.0075,2.66,-0.09,65910,12148,25477,51,42756,23949,54955,49477,10955,16433,"(CONTRACTS OF CHF 125,000)"
19/08/2008,CHF,1.091,-0.39%,-0.0039,2.61,-0.3,62081,9683,23085,488,38575,21177,48746,44750,13335,17331,"(CONTRACTS OF CHF 125,000)"
12/08/2008,CHF,1.0868,-3.10%,-0.0306,2.61,-0.24,58312,13555,21938,156,33080,20621,46791,42715,11521,15597,"(CONTRACTS OF CHF 125,000)"
05/08/2008,CHF,1.0541,-0.77%,-0.0077,2.67,-0.16,59128,14986,23969,0,30179,19451,45165,43420,13963,15708,"(CONTRACTS OF CHF 125,000)"
29/07/2008,CHF,1.046,-1.48%,-0.0147,2.67,-0.04,56449,17401,22056,0,22274,18567,39675,40623,16774,15826,"(CONTRACTS OF CHF 125,000)"
22/07/2008,CHF,1.0307,-2.20%,-0.0218,2.63,-0.25,51791,17900,19566,0,12680,19115,30580,38681,21211,13110,"(CONTRACTS OF CHF 125,000)"
15/07/2008,CHF,1.0085,2.44%,0.0247,2.8,-0.07,63754,32874,17830,29,6877,36637,39780,54496,23974,9258,"(CONTRACTS OF CHF 125,000)"
08/07/2008,CHF,1.0337,-1.37%,-0.0136,2.72,-0.28,52188,18085,22782,29,12400,17810,30514,40621,21674,11567,"(CONTRACTS OF CHF 125,000)"
01/07/2008,CHF,1.0197,2.08%,0.0211,2.74,-0.08,56638,26040,19433,0,8359,25869,34399,45302,22239,11336,"(CONTRACTS OF CHF 125,000)"
24/06/2008,CHF,1.0414,0.09%,0.0009,2.67,-0.18,45574,14081,16482,0,13652,17799,27733,34281,17841,11293,"(CONTRACTS OF CHF 125,000)"
17/06/2008,CHF,1.0423,-0.07%,-0.0007,2.83,-0.06,44091,10824,19738,0,15289,11735,26113,31473,17978,12618,"(CONTRACTS OF CHF 125,000)"
10/06/2008,CHF,1.0416,0.02%,0.0002,2.74,-0.09,68666,15820,19552,2157,31843,31292,49820,53001,18846,15665,"(CONTRACTS OF CHF 125,000)"
03/06/2008,CHF,1.0418,-0.71%,-0.007,2.65,-0.03,65317,14128,21399,700,33094,26301,47922,48400,17395,16917,"(CONTRACTS OF CHF 125,000)"
27/05/2008,CHF,1.0345,0.24%,0.0024,2.77,0.13,69571,18907,28756,2,31423,29391,50332,58149,19239,11422,"(CONTRACTS OF CHF 125,000)"
20/05/2008,CHF,1.037,1.59%,0.0161,2.65,0.01,62984,19037,23980,0,24695,27624,43732,51604,19252,11380,"(CONTRACTS OF CHF 125,000)"
13/05/2008,CHF,1.0538,-0.18%,-0.0018,2.6,-0.1,69188,13758,31194,0,38374,24647,52132,55841,17056,13347,"(CONTRACTS OF CHF 125,000)"
06/05/2008,CHF,1.0519,-1.38%,-0.0137,2.68,-0.09,63405,19125,23262,5,28267,25718,47397,48985,16008,14420,"(CONTRACTS OF CHF 125,000)"
29/04/2008,CHF,1.0376,-3.48%,-0.0342,2.74,-0.16,59678,26625,19624,4,17411,29112,44040,48740,15638,10938,"(CONTRACTS OF CHF 125,000)"
22/04/2008,CHF,1.0027,-0.27%,-0.0027,2.8,-0.2,59593,24731,21722,1,15849,27879,40581,49602,19012,9991,"(CONTRACTS OF CHF 125,000)"
15/04/2008,CHF,1,1.43%,0.0144,2.81,0.06,61278,27058,21824,1,15416,29349,42475,51174,18803,10104,"(CONTRACTS OF CHF 125,000)"
08/04/2008,CHF,1.0145,-0.21%,-0.0021,2.75,-0.07,57506,24145,23228,2,14080,26105,38227,49335,19279,8171,"(CONTRACTS OF CHF 125,000)"
01/04/2008,CHF,1.0124,-0.63%,-0.0062,2.86,0.1,56967,30785,21904,1,8268,26306,39054,48211,17913,8756,"(CONTRACTS OF CHF 125,000)"
25/03/2008,CHF,1.0061,-0.40%,-0.004,2.71,0.12,57488,30768,19987,4,6578,30010,37350,50001,20138,7487,"(CONTRACTS OF CHF 125,000)"
18/03/2008,CHF,1.0021,3.02%,0.0307,2.72,0.11,54366,24560,13336,95,6985,32207,31640,45638,22726,8728,"(CONTRACTS OF CHF 125,000)"
11/03/2008,CHF,1.0333,0.45%,0.0045,2.71,-0.06,90384,25646,29894,900,39069,49752,65615,80546,24769,9838,"(CONTRACTS OF CHF 125,000)"
04/03/2008,CHF,1.038,3.46%,0.0352,2.63,-0.24,81574,24647,24480,120,30012,47310,54779,71910,26795,9664,"(CONTRACTS OF CHF 125,000)"
26/02/2008,CHF,1.0752,1.73%,0.0174,2.67,-0.4,78947,32085,23313,100,23607,46168,55792,69581,23155,9366,"(CONTRACTS OF CHF 125,000)"
19/02/2008,CHF,1.0941,0.68%,0.0068,2.63,-0.44,68500,23979,22992,11,23381,36283,47371,59286,21129,9214,"(CONTRACTS OF CHF 125,000)"
12/02/2008,CHF,1.1016,-0.17%,-0.0017,2.63,-0.27,57989,17550,14370,11,18023,35696,35584,50077,22405,7912,"(CONTRACTS OF CHF 125,000)"
05/02/2008,CHF,1.0997,-0.55%,-0.0055,2.5,-0.46,64353,22588,19802,11,19172,35367,41771,55180,22582,9173,"(CONTRACTS OF CHF 125,000)"
29/01/2008,CHF,1.0937,0.16%,0.0016,2.5,-0.74,70806,28578,19345,8,19615,42772,48201,62125,22605,8681,"(CONTRACTS OF CHF 125,000)"
22/01/2008,CHF,1.0954,-0.24%,-0.0024,2.52,-0.8,71705,28949,13573,11,18430,51242,47390,64826,24315,6879,"(CONTRACTS OF CHF 125,000)"
15/01/2008,CHF,1.0928,1.74%,0.0176,2.57,-1.38,67556,25415,20253,0,19597,38251,45012,58504,22544,9052,"(CONTRACTS OF CHF 125,000)"
08/01/2008,CHF,1.1122,1.88%,0.019,2.69,-1.6,62749,21345,23516,0,20724,31809,42069,55325,20680,7424,"(CONTRACTS OF CHF 125,000)"
31/12/2007,CHF,1.1335,2.00%,0.0202,2.55,-2.18,61358,18502,23121,0,26082,29835,44584,52956,16774,8402,"(CONTRACTS OF CHF 125,000)"
24/12/2007,CHF,1.1566,-0.36%,-0.0036,2.64,-2.13,60681,12643,24140,0,29969,27583,42612,51723,18069,8958,"(CONTRACTS OF CHF 125,000)"
18/12/2007,CHF,1.1525,-1.97%,-0.0195,2.66,-2.33,60246,14677,21661,0,26358,27969,41035,49630,19211,10616,"(CONTRACTS OF CHF 125,000)"
11/12/2007,CHF,1.1302,-1.26%,-0.0126,2.65,-2.63,86792,26684,24751,536,39713,52836,66933,78123,19859,8669,"(CONTRACTS OF CHF 125,000)"
04/12/2007,CHF,1.1161,-1.06%,-0.0105,2.65,-2.54,77920,30533,23490,573,25522,44647,56628,68710,21292,9210,"(CONTRACTS OF CHF 125,000)"
27/11/2007,CHF,1.1044,0.25%,0.0025,2.62,-2.44,81879,37072,23870,645,19959,47666,57676,72181,24203,9698,"(CONTRACTS OF CHF 125,000)"
20/11/2007,CHF,1.1072,1.75%,0.0176,2.6,-2.3,83181,37165,23433,519,18608,49082,56292,73034,26889,10147,"(CONTRACTS OF CHF 125,000)"
13/11/2007,CHF,1.1269,1.59%,0.016,2.68,-2.12,77136,33093,17590,2,17650,47910,50745,65502,26391,11634,"(CONTRACTS OF CHF 125,000)"
06/11/2007,CHF,1.1451,1.22%,0.0122,2.57,-2.24,86821,32575,30156,23,29028,45572,61626,75751,25195,11070,"(CONTRACTS OF CHF 125,000)"
30/10/2007,CHF,1.1592,1.14%,0.0115,2.62,-2.11,72401,32274,21484,2,17091,41075,49367,62561,23034,9840,"(CONTRACTS OF CHF 125,000)"
23/10/2007,CHF,1.1726,0.90%,0.009,2.64,-2.24,69629,26611,24101,0,20936,32118,47547,56219,22082,13410,"(CONTRACTS OF CHF 125,000)"
16/10/2007,CHF,1.1832,0.02%,0.0002,2.74,-2.38,76520,26550,34739,0,28198,28959,54748,63698,21772,12822,"(CONTRACTS OF CHF 125,000)"
09/10/2007,CHF,1.1834,-0.72%,-0.0072,2.72,-2.43,70197,28185,32276,0,18582,27594,46767,59870,23430,10327,"(CONTRACTS OF CHF 125,000)"
02/10/2007,CHF,1.1749,-0.74%,-0.0073,2.68,-2.61,75617,31596,34674,0,19058,31154,50654,65828,24963,9789,"(CONTRACTS OF CHF 125,000)"
25/09/2007,CHF,1.1663,1.24%,0.0125,2.64,-2.6,70582,32958,26666,2,14495,33804,47455,60472,23127,10110,"(CONTRACTS OF CHF 125,000)"
18/09/2007,CHF,1.181,0.69%,0.0069,2.55,-2.65,66122,28647,23158,3,16440,34060,45090,57221,21032,8901,"(CONTRACTS OF CHF 125,000)"
11/09/2007,CHF,1.1892,1.87%,0.0189,2.8,-2.91,136045,26527,23866,1876,90158,96887,118561,122629,17484,13416,"(CONTRACTS OF CHF 125,000)"
04/09/2007,CHF,1.2119,-0.94%,-0.0094,2.81,-2.92,131156,12078,46553,1057,105019,69360,118154,116970,13002,14186,"(CONTRACTS OF CHF 125,000)"
28/08/2007,CHF,1.2006,0.48%,0.0048,2.72,-2.74,118870,17923,36046,2,89323,69527,107248,105575,11622,13295,"(CONTRACTS OF CHF 125,000)"
21/08/2007,CHF,1.2064,0.35%,0.0035,2.84,-2.61,111735,14642,31921,78,85155,67650,99875,99649,11860,12086,"(CONTRACTS OF CHF 125,000)"
14/08/2007,CHF,1.2106,-1.14%,-0.0113,2.69,-2.8,117264,26255,40245,749,72603,65120,99607,106114,17657,11150,"(CONTRACTS OF CHF 125,000)"
07/08/2007,CHF,1.197,0.32%,0.0033,2.67,-2.65,121823,34401,36705,747,66018,70306,101166,107758,20657,14065,"(CONTRACTS OF CHF 125,000)"
31/07/2007,CHF,1.2009,0.12%,0.0012,2.65,-2.65,116838,28309,42942,187,74115,58284,102611,101413,14227,15425,"(CONTRACTS OF CHF 125,000)"
24/07/2007,CHF,1.2024,-0.07%,-0.0007,2.68,-2.63,115383,21909,64786,188,78675,34685,100772,99659,14611,15724,"(CONTRACTS OF CHF 125,000)"
17/07/2007,CHF,1.2016,0.04%,0.0004,2.66,-2.65,110578,24189,59743,188,71426,32875,95803,92806,14775,17772,"(CONTRACTS OF CHF 125,000)"
10/07/2007,CHF,1.2021,1.10%,0.0111,2.66,-2.66,102992,20339,58411,0,70250,26864,90589,85275,12403,17717,"(CONTRACTS OF CHF 125,000)"
03/07/2007,CHF,1.2155,1.03%,0.0103,2.58,-2.71,95030,14876,48451,0,69804,27367,84680,75818,10350,19212,"(CONTRACTS OF CHF 125,000)"
26/06/2007,CHF,1.2281,1.01%,0.0101,2.61,-2.65,101945,8303,67134,0,85894,10089,94197,77223,7748,24722,"(CONTRACTS OF CHF 125,000)"
19/06/2007,CHF,1.2406,0.10%,0.001,2.42,-2.87,110556,6682,86013,11,95587,2206,102280,88230,8276,22326,"(CONTRACTS OF CHF 125,000)"
12/06/2007,CHF,1.2419,-1.99%,-0.0197,2.41,-2.87,155140,10341,89522,1074,131863,43904,143278,134500,11862,20640,"(CONTRACTS OF CHF 125,000)"
05/06/2007,CHF,1.2177,0.61%,0.0061,2.37,-2.91,99547,11536,69788,525,76290,9178,88351,79491,11196,20056,"(CONTRACTS OF CHF 125,000)"
29/05/2007,CHF,1.2252,0.33%,0.0033,2.4,-2.89,97517,9644,68852,12,76951,7259,86607,76123,10910,21394,"(CONTRACTS OF CHF 125,000)"
22/05/2007,CHF,1.2293,-1.18%,-0.0117,2.38,-2.88,100303,9372,75241,162,79682,5471,89216,80874,11087,19429,"(CONTRACTS OF CHF 125,000)"
15/05/2007,CHF,1.215,0.25%,0.0025,2.33,-2.93,81328,17093,51838,482,51673,14385,69248,66705,12080,14623,"(CONTRACTS OF CHF 125,000)"
08/05/2007,CHF,1.2181,-0.31%,-0.0031,2.31,-2.95,81736,14860,49212,622,51567,17780,67049,67614,14687,14122,"(CONTRACTS OF CHF 125,000)"
01/05/2007,CHF,1.2143,-1.09%,-0.0108,2.26,-3,79989,16669,47839,654,46332,19270,63655,67763,16334,12226,"(CONTRACTS OF CHF 125,000)"
24/04/2007,CHF,1.2012,0.61%,0.0061,2.23,-3.02,77956,23229,40080,230,36288,24841,59747,65151,18209,12805,"(CONTRACTS OF CHF 125,000)"
17/04/2007,CHF,1.2086,0.65%,0.0065,2.25,-3.02,67565,17907,40279,242,32831,15524,50980,56045,16585,11520,"(CONTRACTS OF CHF 125,000)"
10/04/2007,CHF,1.2165,0.47%,0.0047,2.21,-3.05,58718,13453,36659,12,31840,10012,45305,46683,13413,12035,"(CONTRACTS OF CHF 125,000)"
03/04/2007,CHF,1.2222,-0.86%,-0.0085,2.24,-3.01,57666,10294,37559,0,29494,8277,39788,45836,17878,11830,"(CONTRACTS OF CHF 125,000)"
27/03/2007,CHF,1.2118,-0.01%,-0.0001,2.18,-3.07,52720,18597,30156,0,17102,11763,35699,41919,17021,10801,"(CONTRACTS OF CHF 125,000)"
20/03/2007,CHF,1.2117,0.45%,0.0045,2.15,-3.1,53302,16020,31022,0,16321,7890,32341,38912,20961,14390,"(CONTRACTS OF CHF 125,000)"
13/03/2007,CHF,1.2172,0.53%,0.0053,2.14,-3.11,88190,15012,39903,1308,54571,34412,70891,75623,17299,12567,"(CONTRACTS OF CHF 125,000)"
06/03/2007,CHF,1.2237,-0.51%,-0.0051,2.14,-3.12,83320,16859,38726,140,48582,32079,65581,70945,17739,12375,"(CONTRACTS OF CHF 125,000)"
27/02/2007,CHF,1.2175,1.49%,0.015,2.15,-3.1,103378,15823,60508,7,68318,26010,84148,86525,19230,16853,"(CONTRACTS OF CHF 125,000)"
20/02/2007,CHF,1.2359,0.87%,0.0087,2.15,-3.15,100274,5525,61078,253,81011,22726,86789,84057,13485,16217,"(CONTRACTS OF CHF 125,000)"
13/02/2007,CHF,1.2467,-0.54%,-0.0054,2.12,-3.18,107988,6693,70099,119,91264,17941,98076,88159,9912,19829,"(CONTRACTS OF CHF 125,000)"
06/02/2007,CHF,1.24,0.93%,0.0094,2.16,-3.14,93536,9393,52318,81,74703,23721,84177,76120,9359,17416,"(CONTRACTS OF 125,000 SWISS FRANCS)"
30/01/2007,CHF,1.2517,-0.73%,-0.0073,2.13,-3.17,99642,5819,65399,81,83755,15658,89655,81138,9987,18504,"(CONTRACTS OF 125,000 SWISS FRANCS)"
23/01/2007,CHF,1.2426,0.46%,0.0046,2.09,-3.18,83065,5290,49371,36,67899,15298,73225,64705,9840,18360,"(CONTRACTS OF 125,000 SWISS FRANCS)"
16/01/2007,CHF,1.2483,-0.58%,-0.0058,2.09,-3.17,83803,6476,48724,36,65958,14769,72470,63529,11333,20274,"(CONTRACTS OF 125,000 SWISS FRANCS)"
09/01/2007,CHF,1.2411,-2.31%,-0.0228,2.08,-3.21,80925,7698,48069,243,60189,17343,68130,65655,12795,15270,"(CONTRACTS OF 125,000 SWISS FRANCS)"
03/01/2007,CHF,1.2131,0.79%,0.0079,2.04,-3.22,64732,11280,34078,176,38081,18536,49537,52790,15195,11942,"(CONTRACTS OF 125,000 SWISS FRANCS)"
26/12/2006,CHF,1.2227,-0.68%,-0.0068,1.99,-3.31,57050,17614,29899,15,22512,15569,40141,45483,16909,11567,"(CONTRACTS OF 125,000 SWISS FRANCS)"
19/12/2006,CHF,1.2144,-1.24%,-0.0123,1.97,-3.33,54652,18315,29153,0,16662,16678,34977,45831,19675,8821,"(CONTRACTS OF 125,000 SWISS FRANCS)"
12/12/2006,CHF,1.1995,-0.68%,-0.0068,1.91,-3.38,92840,24981,34753,476,44970,48340,70427,83569,22413,9271,"(CONTRACTS OF 125,000 SWISS FRANCS)"
05/12/2006,CHF,1.1914,0.88%,0.0089,1.86,-3.42,80908,25835,32303,796,28496,35368,55127,68467,25781,12441,"(CONTRACTS OF 125,000 SWISS FRANCS)"
28/11/2006,CHF,1.202,3.12%,0.0317,1.84,-3.43,78706,21961,35864,0,37140,29557,59101,65421,19605,13285,"(CONTRACTS OF 125,000 SWISS FRANCS)"
21/11/2006,CHF,1.2407,0.23%,0.0023,1.82,-3.44,84320,10633,49430,0,60086,18417,70719,67847,13601,16473,"(CONTRACTS OF 125,000 SWISS FRANCS)"
14/11/2006,CHF,1.2435,0.51%,0.0051,1.8,-3.49,87935,9883,52428,0,64464,19539,74347,71967,13588,15968,"(CONTRACTS OF 125,000 SWISS FRANCS)"
07/11/2006,CHF,1.2499,-0.49%,-0.0049,1.81,-3.47,103184,14326,70027,0,77233,13343,91559,83370,11625,19814,"(CONTRACTS OF 125,000 SWISS FRANCS)"
31/10/2006,CHF,1.2438,1.79%,0.0181,1.78,-3.49,89968,11230,58299,0,68592,11763,79822,70062,10146,19906,"(CONTRACTS OF 125,000 SWISS FRANCS)"
24/10/2006,CHF,1.2665,0.14%,0.0014,1.81,-3.47,107816,9331,79554,0,89954,3969,99285,83523,8531,24293,"(CONTRACTS OF 125,000 SWISS FRANCS)"
17/10/2006,CHF,1.2683,0.12%,0.0012,1.75,-3.52,105046,10504,77712,0,87178,3826,97682,81538,7364,23508,"(CONTRACTS OF 125,000 SWISS FRANCS)"
10/10/2006,CHF,1.2698,-2.00%,-0.0198,1.72,-3.59,95979,8870,69290,0,77960,4329,86830,73619,9149,22360,"(CONTRACTS OF 125,000 SWISS FRANCS)"
03/10/2006,CHF,1.2449,-0.13%,-0.0013,1.77,-3.54,72687,10759,40886,0,51972,11649,62731,52535,9956,20152,"(CONTRACTS OF 125,000 SWISS FRANCS)"
26/09/2006,CHF,1.2433,0.65%,0.0065,1.7,-3.59,69977,10497,39517,0,50350,11296,60847,50813,9130,19164,"(CONTRACTS OF 125,000 SWISS FRANCS)"
19/09/2006,CHF,1.2514,-0.05%,-0.0005,1.69,-3.64,76994,10111,54145,0,57429,2482,67540,56627,9454,20367,"(CONTRACTS OF 125,000 SWISS FRANCS)"
12/09/2006,CHF,1.2508,-1.39%,-0.0138,1.62,-3.72,98012,12013,45254,70,74761,31857,86844,77181,11168,20831,"(CONTRACTS OF 125,000 SWISS FRANCS)"
05/09/2006,CHF,1.2337,-0.42%,-0.0041,1.62,-3.7,70053,11221,30367,0,46601,25569,57822,55936,12231,14117,"(CONTRACTS OF 125,000 SWISS FRANCS)"
29/08/2006,CHF,1.2286,0.45%,0.0045,1.59,-3.75,68787,12618,25253,464,44256,29265,57338,54982,11449,13805,"(CONTRACTS OF 125,000 SWISS FRANCS)"
22/08/2006,CHF,1.2341,0.23%,0.0023,1.57,-3.77,68484,16847,27312,506,38181,27544,55534,55362,12950,13122,"(CONTRACTS OF 125,000 SWISS FRANCS)"
15/08/2006,CHF,1.2369,-0.93%,-0.0093,1.55,-3.8,66021,13082,28329,0,40934,22521,54016,50850,12005,15171,"(CONTRACTS OF 125,000 SWISS FRANCS)"
08/08/2006,CHF,1.2255,0.03%,0.0003,1.49,-3.9,72643,21484,36337,0,36065,22775,57549,59112,15094,13531,"(CONTRACTS OF 125,000 SWISS FRANCS)"
01/08/2006,CHF,1.2259,2.19%,0.0222,1.46,-3.96,65105,17487,26881,0,35522,21491,53009,48372,12096,16733,"(CONTRACTS OF 125,000 SWISS FRANCS)"
25/07/2006,CHF,1.2534,-0.07%,-0.0007,1.47,-3.96,73560,16611,37571,36,45151,17788,61798,55395,11762,18165,"(CONTRACTS OF 125,000 SWISS FRANCS)"
18/07/2006,CHF,1.2525,-2.18%,-0.0215,1.5,-3.95,69612,18116,33533,0,40527,18602,58643,52135,10969,17477,"(CONTRACTS OF 125,000 SWISS FRANCS)"
11/07/2006,CHF,1.2258,-0.13%,-0.0013,1.47,-3.99,62771,20120,27379,0,30495,23670,50615,51049,12156,11722,"(CONTRACTS OF 125,000 SWISS FRANCS)"
03/07/2006,CHF,1.2242,1.49%,0.015,1.45,-3.98,58809,21327,25641,0,26070,20703,47397,46344,11412,12465,"(CONTRACTS OF 125,000 SWISS FRANCS)"
27/06/2006,CHF,1.2427,-0.38%,-0.0038,1.43,-4.03,63556,14509,30398,36,36665,19565,51210,49999,12346,13557,"(CONTRACTS OF 125,000 SWISS FRANCS)"
20/06/2006,CHF,1.238,0.06%,0.0006,1.42,-3.96,57617,20297,25769,36,24895,19561,45228,45366,12389,12251,"(CONTRACTS OF 125,000 SWISS FRANCS)"
13/06/2006,CHF,1.2387,-1.88%,-0.0187,1.41,-3.87,122926,21176,24058,304,86167,85686,107647,110048,15279,12878,"(CONTRACTS OF 125,000 SWISS FRANCS)"
06/06/2006,CHF,1.2158,-0.42%,-0.0042,1.39,-3.83,107626,26639,17319,621,60428,77026,87688,94966,19938,12660,"(CONTRACTS OF 125,000 SWISS FRANCS)"
30/05/2006,CHF,1.2107,-0.20%,-0.002,1.35,-3.83,100852,30264,19733,80,50973,70528,81317,90341,19535,10511,"(CONTRACTS OF 125,000 SWISS FRANCS)"
23/05/2006,CHF,1.2083,-0.12%,-0.0012,1.34,-3.81,101734,30138,21756,80,51282,68412,81500,90248,20234,11486,"(CONTRACTS OF 125,000 SWISS FRANCS)"
16/05/2006,CHF,1.2069,1.07%,0.0108,1.33,-3.79,100736,23935,25516,161,54887,62764,78983,88441,21753,12295,"(CONTRACTS OF 125,000 SWISS FRANCS)"
09/05/2006,CHF,1.22,1.41%,0.0142,1.33,-3.78,94856,18306,29319,259,56191,48706,74756,78284,20100,16572,"(CONTRACTS OF 125,000 SWISS FRANCS)"
02/05/2006,CHF,1.2374,2.37%,0.024,1.3,-3.8,89956,17518,30147,0,56625,45190,74143,75337,15813,14619,"(CONTRACTS OF 125,000 SWISS FRANCS)"
25/04/2006,CHF,1.2674,0.10%,0.001,1.22,-3.83,84075,12113,36542,0,56211,29554,68324,66096,15751,17979,"(CONTRACTS OF 125,000 SWISS FRANCS)"
18/04/2006,CHF,1.2687,2.21%,0.0224,1.21,-3.82,80925,10744,32912,123,55955,29450,66822,62485,14103,18440,"(CONTRACTS OF 125,000 SWISS FRANCS)"
11/04/2006,CHF,1.2974,-0.55%,-0.0055,1.18,-3.82,78605,6470,35121,295,61557,23376,68322,58792,10283,19813,"(CONTRACTS OF 125,000 SWISS FRANCS)"
04/04/2006,CHF,1.2903,1.44%,0.0145,1.22,-3.75,79020,7412,45540,0,62580,11064,69992,56604,9028,22416,"(CONTRACTS OF 125,000 SWISS FRANCS)"
28/03/2006,CHF,1.3092,-0.57%,-0.0057,1.14,-3.78,84695,5820,51155,199,72362,11321,78381,62675,6314,22020,"(CONTRACTS OF 125,000 SWISS FRANCS)"
21/03/2006,CHF,1.3018,0.06%,0.0006,1.12,-3.74,83307,3462,50327,0,70686,10420,74148,60747,9159,22560,"(CONTRACTS OF 125,000 SWISS FRANCS)"
14/03/2006,CHF,1.3026,0.81%,0.0081,1.16,-3.7,93713,7429,55807,36,78117,14175,85582,70018,8131,23695,"(CONTRACTS OF 125,000 SWISS FRANCS)"
07/03/2006,CHF,1.3132,-0.10%,-0.001,1.13,-3.66,127779,15975,62198,113,102536,38689,118624,101000,9155,26779,"(CONTRACTS OF 125,000 SWISS FRANCS)"
28/02/2006,CHF,1.3119,-0.27%,-0.0027,1.1,-3.63,134418,16309,84571,0,107965,24547,124274,109118,10144,25300,"(CONTRACTS OF 125,000 SWISS FRANCS)"
21/02/2006,CHF,1.3084,-0.06%,-0.0006,1.06,-3.66,112408,23789,60764,0,78821,28237,102610,89001,9798,23407,"(CONTRACTS OF 125,000 SWISS FRANCS)"
14/02/2006,CHF,1.3076,-0.76%,-0.0076,1.02,-3.66,108343,21612,52800,101,77521,33516,99234,86417,9109,21926,"(CONTRACTS OF 125,000 SWISS FRANCS)"
07/02/2006,CHF,1.2977,-1.55%,-0.0154,0.99,-3.65,92132,23624,38314,0,60312,35349,83936,73663,8196,18469,"(CONTRACTS OF 125,000 SWISS FRANCS)"
31/01/2006,CHF,1.2779,-1.41%,-0.014,0.97,-3.71,84122,26222,25239,72,44582,41872,70876,67183,13246,16939,"(CONTRACTS OF 125,000 SWISS FRANCS)"
24/01/2006,CHF,1.2601,1.55%,0.0157,0.93,-3.61,85876,24328,19965,0,46191,52763,70519,72728,15357,13148,"(CONTRACTS OF 125,000 SWISS FRANCS)"
17/01/2006,CHF,1.28,0.01%,0.0001,0.93,-3.64,80480,21356,19896,0,46484,44430,67840,64326,12640,16154,"(CONTRACTS OF 125,000 SWISS FRANCS)"
10/01/2006,CHF,1.2801,0.83%,0.0083,0.95,-3.58,79029,24138,24378,0,41059,39837,65197,64215,13832,14814,"(CONTRACTS OF 125,000 SWISS FRANCS)"
03/01/2006,CHF,1.2908,2.01%,0.0203,0.92,-3.61,77368,15002,31513,0,53848,24025,68850,55538,8518,21830,"(CONTRACTS OF 125,000 SWISS FRANCS)"
27/12/2005,CHF,1.3173,-0.73%,-0.0072,0.95,-3.56,86551,9032,47358,0,69968,17768,79000,65126,7551,21425,"(CONTRACTS OF 125,000 SWISS FRANCS)"
20/12/2005,CHF,1.3078,-1.08%,-0.0108,0.94,-3.54,75904,5247,39314,0,61359,15858,66606,55172,9298,20732,"(CONTRACTS OF 125,000 SWISS FRANCS)"
13/12/2005,CHF,1.2938,0.92%,0.0092,1.01,-3.39,113909,13937,53798,1635,87271,37406,102843,92839,11066,21070,"(CONTRACTS OF 125,000 SWISS FRANCS)"
06/12/2005,CHF,1.3058,0.54%,0.0054,0.99,-3.39,105413,16550,65909,225,79418,16949,96193,83083,9220,22330,"(CONTRACTS OF 125,000 SWISS FRANCS)"
29/11/2005,CHF,1.3129,-0.14%,-0.0014,0.96,-3.37,99363,14195,62611,0,78005,13197,92200,75808,7163,23555,"(CONTRACTS OF 125,000 SWISS FRANCS)"
22/11/2005,CHF,1.3111,0.43%,0.0043,0.93,-3.4,100881,15191,63398,0,78940,14203,94131,77601,6750,23280,"(CONTRACTS OF 125,000 SWISS FRANCS)"
15/11/2005,CHF,1.3167,-0.47%,-0.0046,0.86,-3.43,98446,15132,60166,0,76659,12671,91791,72837,6655,25609,"(CONTRACTS OF 125,000 SWISS FRANCS)"
08/11/2005,CHF,1.3106,-1.73%,-0.0172,0.82,-3.44,84753,13830,48500,0,63424,12442,77254,60942,7499,23811,"(CONTRACTS OF 125,000 SWISS FRANCS)"
01/11/2005,CHF,1.2883,-0.96%,-0.0096,0.82,-3.39,69574,13637,35416,55,47185,11374,60877,46845,8697,22729,"(CONTRACTS OF 125,000 SWISS FRANCS)"
25/10/2005,CHF,1.276,1.68%,0.0169,0.75,-3.41,66764,12814,33657,356,44806,13183,57976,47196,8788,19568,"(CONTRACTS OF 125,000 SWISS FRANCS)"
18/10/2005,CHF,1.2978,-0.66%,-0.0066,0.7,-3.4,80322,13958,44940,0,58497,10814,72455,55754,7867,24568,"(CONTRACTS OF 125,000 SWISS FRANCS)"
11/10/2005,CHF,1.2893,0.94%,0.0094,0.75,-3.3,72377,13572,38859,0,52286,12327,65858,51186,6519,21191,"(CONTRACTS OF 125,000 SWISS FRANCS)"
04/10/2005,CHF,1.3015,-0.49%,-0.0049,0.76,-3.26,87779,9973,57099,0,69953,8884,79926,65983,7853,21796,"(CONTRACTS OF 125,000 SWISS FRANCS)"
27/09/2005,CHF,1.2951,-1.05%,-0.0104,0.72,-3.21,76757,6138,49869,0,64282,6296,70420,56165,6337,20592,"(CONTRACTS OF 125,000 SWISS FRANCS)"
20/09/2005,CHF,1.2817,-1.61%,-0.016,0.71,-3.16,57198,2488,33398,0,45590,6728,48078,40126,9120,17072,"(CONTRACTS OF 125,000 SWISS FRANCS)"
13/09/2005,CHF,1.2614,-1.86%,-0.0184,0.71,-3.05,60845,4175,19141,147,43370,29536,47692,48824,13153,12021,"(CONTRACTS OF 125,000 SWISS FRANCS)"
06/09/2005,CHF,1.2384,2.46%,0.0249,0.68,-3.01,61472,14944,15729,522,36899,37451,52365,53702,9107,7770,"(CONTRACTS OF 125,000 SWISS FRANCS)"
30/08/2005,CHF,1.2696,0.03%,0.0003,0.66,-3.1,67721,4008,35884,1,63581,22735,67590,58620,131,9101,"(CONTRACTS OF 125,000 SWISS FRANCS)"
23/08/2005,CHF,1.27,-1.21%,-0.012,0.71,-3.07,67995,3165,40709,34,55438,10104,58637,50847,9358,17148,"(CONTRACTS OF 125,000 SWISS FRANCS)"
16/08/2005,CHF,1.2548,0.36%,0.0036,0.71,-3.03,66890,6485,34107,407,48828,15343,55720,49857,11170,17033,"(CONTRACTS OF 125,000 SWISS FRANCS)"
09/08/2005,CHF,1.2593,1.34%,0.0135,0.71,-2.98,71277,6045,38256,34,56219,12407,62298,50697,8979,20580,"(CONTRACTS OF 125,000 SWISS FRANCS)"
02/08/2005,CHF,1.2764,1.79%,0.0181,0.71,-2.95,71327,4633,35959,24,58879,13085,63536,49068,7791,22259,"(CONTRACTS OF 125,000 SWISS FRANCS)"
26/07/2005,CHF,1.2997,-0.01%,-0.0001,0.7,-2.92,73768,4604,41033,1,62539,8799,67144,49833,6624,23935,"(CONTRACTS OF 125,000 SWISS FRANCS)"
19/07/2005,CHF,1.2996,-2.26%,-0.0223,0.7,-2.87,72416,6019,42511,1,59067,7684,65087,50196,7329,22220,"(CONTRACTS OF 125,000 SWISS FRANCS)"
12/07/2005,CHF,1.2709,2.50%,0.0253,0.7,-2.84,69525,2991,40939,0,57922,6205,60913,47144,8612,22381,"(CONTRACTS OF 125,000 SWISS FRANCS)"
05/07/2005,CHF,1.3035,-1.75%,-0.0173,0.7,-2.83,73790,1694,47234,0,63939,4733,65633,51967,8157,21823,"(CONTRACTS OF 125,000 SWISS FRANCS)"
28/06/2005,CHF,1.2811,-1.21%,-0.012,0.69,-2.72,73119,1764,46185,0,63541,4868,65305,51053,7814,22066,"(CONTRACTS OF 125,000 SWISS FRANCS)"
21/06/2005,CHF,1.2658,0.95%,0.0095,0.63,-2.8,71529,1579,43966,0,61527,4662,63106,48628,8423,22901,"(CONTRACTS OF 125,000 SWISS FRANCS)"
14/06/2005,CHF,1.2779,-2.62%,-0.0258,0.66,-2.69,73534,2905,46486,0,64004,4362,66909,50848,6625,22686,"(CONTRACTS OF 125,000 SWISS FRANCS)"
07/06/2005,CHF,1.2453,0.17%,0.0017,0.65,-2.65,90020,1943,47255,1,78431,19011,80375,66267,9645,23753,"(CONTRACTS OF 125,000 SWISS FRANCS)"
31/05/2005,CHF,1.2474,-1.51%,-0.015,0.63,-2.64,69037,850,40249,53,58759,6938,59662,47240,9375,21797,"(CONTRACTS OF 125,000 SWISS FRANCS)"
24/05/2005,CHF,1.2288,-0.28%,-0.0028,0.64,-2.55,69873,1762,39433,57,59616,7279,61435,46769,8438,23104,"(CONTRACTS OF 125,000 SWISS FRANCS)"
17/05/2005,CHF,1.2254,-2.08%,-0.0206,0.7,-2.47,60958,1942,30320,12,48791,7702,50745,38034,10213,22924,"(CONTRACTS OF 125,000 SWISS FRANCS)"
10/05/2005,CHF,1.2004,-0.15%,-0.0015,0.69,-2.49,43977,2214,19638,29,32738,7641,34981,27308,8996,16669,"(CONTRACTS OF 125,000 SWISS FRANCS)"
03/05/2005,CHF,1.1986,-1.01%,-0.0101,0.67,-2.46,38584,4889,16219,1,24752,8284,29642,24504,8942,14080,"(CONTRACTS OF 125,000 SWISS FRANCS)"
26/04/2005,CHF,1.1866,-0.52%,-0.0052,0.69,-2.41,34396,3504,12129,1,21121,7719,24626,19849,9770,14547,"(CONTRACTS OF 125,000 SWISS FRANCS)"
19/04/2005,CHF,1.1805,1.51%,0.0152,0.69,-2.33,35822,3585,15306,1,22705,6612,26291,21919,9531,13903,"(CONTRACTS OF 125,000 SWISS FRANCS)"
12/04/2005,CHF,1.1986,0.61%,0.0062,0.73,-2.36,45692,1677,24441,1,34607,5605,36285,30047,9407,15645,"(CONTRACTS OF 125,000 SWISS FRANCS)"
05/04/2005,CHF,1.206,-0.37%,-0.0037,0.72,-2.29,47464,1677,20456,1,36790,12476,38468,32933,8996,14531,"(CONTRACTS OF 125,000 SWISS FRANCS)"
29/03/2005,CHF,1.2016,-1.17%,-0.0116,0.65,-2.39,42256,2168,16210,1,30785,11683,32954,27894,9302,14362,"(CONTRACTS OF 125,000 SWISS FRANCS)"
22/03/2005,CHF,1.1877,-1.97%,-0.0195,0.65,-2.31,38278,5242,16598,1,19966,11796,25209,28395,13069,9883,"(CONTRACTS OF 125,000 SWISS FRANCS)"
15/03/2005,CHF,1.1648,-0.28%,-0.0028,0.7,-2.24,41804,10655,10495,1,14830,22524,25486,33020,16318,8784,"(CONTRACTS OF 125,000 SWISS FRANCS)"
08/03/2005,CHF,1.1615,0.36%,0.0036,0.67,-2.18,67512,7474,10501,1346,39556,43558,48376,55405,19136,12107,"(CONTRACTS OF 125,000 SWISS FRANCS)"
01/03/2005,CHF,1.1657,-0.61%,-0.0061,0.64,-2.21,61956,7313,9216,0,36723,39778,44036,48994,17920,12962,"(CONTRACTS OF 125,000 SWISS FRANCS)"
22/02/2005,CHF,1.1586,2.66%,0.027,0.65,-2.18,54437,4790,8240,727,30405,30065,35922,39032,18515,15405,"(CONTRACTS OF 125,000 SWISS FRANCS)"
15/02/2005,CHF,1.1903,2.51%,0.0254,0.67,-2.07,52852,3837,15106,734,37796,21015,42367,36855,10485,15997,"(CONTRACTS OF 125,000 SWISS FRANCS)"
08/02/2005,CHF,1.2209,-2.56%,-0.0253,0.7,-1.99,56861,3371,20545,412,41738,17981,45521,38938,11340,17923,"(CONTRACTS OF 125,000 SWISS FRANCS)"
01/02/2005,CHF,1.1904,0.21%,0.0021,0.62,-2.09,51859,6322,13722,437,34468,23345,41227,37504,10632,14355,"(CONTRACTS OF 125,000 SWISS FRANCS)"
25/01/2005,CHF,1.1929,-0.65%,-0.0065,0.7,-1.94,51069,8043,13224,27,29808,22892,37878,36143,13191,14926,"(CONTRACTS OF 125,000 SWISS FRANCS)"
18/01/2005,CHF,1.1852,-0.23%,-0.0023,0.6,-2,52151,11217,12317,15,27306,27276,38538,39608,13613,12543,"(CONTRACTS OF 125,000 SWISS FRANCS)"
11/01/2005,CHF,1.1825,-1.22%,-0.0121,0.67,-1.9,53634,11883,11823,35,25813,29654,37731,41512,15903,12122,"(CONTRACTS OF 125,000 SWISS FRANCS)"
04/01/2005,CHF,1.1683,-3.03%,-0.0299,0.61,-1.91,50988,19388,7893,2,12266,33078,31656,40973,19332,10015,"(CONTRACTS OF 125,000 SWISS FRANCS)"
28/12/2004,CHF,1.1339,1.64%,0.0165,0.61,-1.85,60282,33728,8739,0,7955,44575,41683,53314,18599,6968,"(CONTRACTS OF 125,000 SWISS FRANCS)"
21/12/2004,CHF,1.1528,0.11%,0.0011,0.69,-1.77,56834,30105,18553,0,9266,31614,39371,50167,17463,6667,"(CONTRACTS OF 125,000 SWISS FRANCS)"
14/12/2004,CHF,1.1541,-1.23%,-0.0122,0.7,-1.71,56671,34319,16759,0,5158,33097,39477,49856,17194,6815,"(CONTRACTS OF 125,000 SWISS FRANCS)"
07/12/2004,CHF,1.1401,-0.05%,-0.0005,0.62,-1.75,100269,40393,4345,108,35767,83840,76268,88293,24001,11976,"(CONTRACTS OF 125,000 SWISS FRANCS)"
30/11/2004,CHF,1.1395,1.62%,0.0164,0.6,-1.74,75035,42761,3823,9,8156,60153,50926,63985,24109,11050,"(CONTRACTS OF 125,000 SWISS FRANCS)"
23/11/2004,CHF,1.1583,1.51%,0.0152,0.7,-1.58,77383,44391,5605,9,7012,61652,51412,67266,25971,10117,"(CONTRACTS OF 125,000 SWISS FRANCS)"
16/11/2004,CHF,1.176,0.62%,0.0062,0.63,-1.61,75763,46659,5654,0,4795,60028,51454,65682,24309,10081,"(CONTRACTS OF 125,000 SWISS FRANCS)"
09/11/2004,CHF,1.1833,1.75%,0.0177,0.71,-1.5,77168,46258,5891,0,5954,63176,52212,69067,24956,8101,"(CONTRACTS OF 125,000 SWISS FRANCS)"
02/11/2004,CHF,1.2044,-0.20%,-0.002,0.6,-1.5,68098,39924,8132,0,4442,54147,44366,62279,23732,5819,"(CONTRACTS OF 125,000 SWISS FRANCS)"
26/10/2004,CHF,1.202,2.22%,0.0225,0.56,-1.48,63595,35403,8072,0,3544,49468,38947,57540,24648,6055,"(CONTRACTS OF 125,000 SWISS FRANCS)"
19/10/2004,CHF,1.2293,2.13%,0.0216,0.57,-1.43,49694,22288,10490,0,8472,32365,30760,42855,18934,6839,"(CONTRACTS OF 125,000 SWISS FRANCS)"
12/10/2004,CHF,1.2561,0.43%,0.0043,0.59,-1.38,35432,8167,12805,1,12956,14834,21124,27640,14308,7792,"(CONTRACTS OF 125,000 SWISS FRANCS)"
05/10/2004,CHF,1.2615,-0.20%,-0.002,0.57,-1.4,31092,5092,9852,1,14377,11541,19470,21394,11622,9698,"(CONTRACTS OF 125,000 SWISS FRANCS)"
28/09/2004,CHF,1.259,-0.41%,-0.0041,0.6,-1.27,29774,5092,10638,0,14846,8230,19938,18868,9836,10906,"(CONTRACTS OF 125,000 SWISS FRANCS)"
07/09/2004,CHF,1.2671,-0.09%,-0.0009,0.52,-1.23,41687,3488,11148,0,27521,15749,31009,26897,10678,14790,"(CONTRACTS OF 125,000 SWISS FRANCS)"
31/08/2004,CHF,1.2659,0.49%,0.0049,0.48,-1.23,41657,3707,11890,283,25894,15299,29884,27472,11773,14185,"(CONTRACTS OF 125,000 SWISS FRANCS)"
24/08/2004,CHF,1.2721,-2.32%,-0.0229,0.45,-1.19,40437,4152,10688,421,24568,17172,29141,28281,11296,12156,"(CONTRACTS OF 125,000 SWISS FRANCS)"
17/08/2004,CHF,1.2433,1.52%,0.0153,0.41,-1.31,40867,6852,9354,421,20364,20401,27637,30176,13230,10691,"(CONTRACTS OF 125,000 SWISS FRANCS)"
10/08/2004,CHF,1.2625,1.24%,0.0124,0.39,-1.28,36349,4420,10849,421,21520,13682,26361,24952,9988,11397,"(CONTRACTS OF 125,000 SWISS FRANCS)"
03/08/2004,CHF,1.2783,-0.26%,-0.0026,0.41,-1.3,42332,3140,15967,0,25603,9734,28743,25701,13589,16631,"(CONTRACTS OF 125,000 SWISS FRANCS)"
27/07/2004,CHF,1.275,-2.50%,-0.0247,0.39,-1.18,40111,8327,9153,0,17977,19666,26304,28819,13807,11292,"(CONTRACTS OF 125,000 SWISS FRANCS)"
20/07/2004,CHF,1.2439,-0.70%,-0.0069,0.39,-1.13,55778,23981,2818,1,8446,42827,32428,45646,23350,10132,"(CONTRACTS OF 125,000 SWISS FRANCS)"
13/07/2004,CHF,1.2353,0.12%,0.0012,0.37,-1.15,60091,29193,2352,1,7362,47370,36556,49723,23535,10368,"(CONTRACTS OF 125,000 SWISS FRANCS)"
06/07/2004,CHF,1.2368,2.31%,0.0233,0.37,-1.15,53561,25146,2970,1,7015,44925,32162,47896,21399,5665,"(CONTRACTS OF 125,000 SWISS FRANCS)"
29/06/2004,CHF,1.266,-1.35%,-0.0134,0.37,-1.17,39116,16232,3883,10,5437,27208,21679,31101,17437,8015,"(CONTRACTS OF 125,000 SWISS FRANCS)"
22/06/2004,CHF,1.2491,-0.04%,-0.0004,0.34,-1.12,42778,18499,1061,0,5302,34526,23801,35587,18977,7191,"(CONTRACTS OF 125,000 SWISS FRANCS)"
15/06/2004,CHF,1.2486,-0.83%,-0.0083,0.3,-1.17,43388,21099,4354,3,5552,30852,26654,35209,16734,8179,"(CONTRACTS OF 125,000 SWISS FRANCS)"
08/06/2004,CHF,1.2383,0.67%,0.0068,0.23,-1.1,69978,22670,6408,13,24430,49658,47113,56079,22865,13899,"(CONTRACTS OF 125,000 SWISS FRANCS)"
01/06/2004,CHF,1.2467,2.06%,0.0208,0.16,-1.05,45970,12108,6786,10,14636,28174,26754,34970,19216,11000,"(CONTRACTS OF 125,000 SWISS FRANCS)"
25/05/2004,CHF,1.2729,0.75%,0.0075,0.15,-1.09,36529,4367,7907,7,19302,16894,23676,24808,12853,11721,"(CONTRACTS OF 125,000 SWISS FRANCS)"
18/05/2004,CHF,1.2825,1.05%,0.0105,0.16,-1,34868,4633,7231,4,21810,16478,26447,23713,8421,11155,"(CONTRACTS OF 125,000 SWISS FRANCS)"
11/05/2004,CHF,1.2961,-1.18%,-0.0117,0.19,-0.95,38467,1244,8139,3,28121,14315,29368,22457,9099,16010,"(CONTRACTS OF 125,000 SWISS FRANCS)"
04/05/2004,CHF,1.281,1.32%,0.0133,0.15,-0.92,36901,1717,8806,0,24895,12101,26612,20907,10289,15994,"(CONTRACTS OF 125,000 SWISS FRANCS)"
27/04/2004,CHF,1.2982,1.10%,0.011,0.18,-0.89,37889,1374,12466,2,27830,6319,29206,18787,8683,19102,"(CONTRACTS OF 125,000 SWISS FRANCS)"
20/04/2004,CHF,1.3126,-2.42%,-0.0239,0.17,-0.91,38936,3757,12060,0,24935,7039,28692,19099,10244,19837,"(CONTRACTS OF 125,000 SWISS FRANCS)"
12/04/2004,CHF,1.2816,0.64%,0.0064,0.17,-0.87,36138,3865,9806,0,21790,11465,25655,21271,10483,14867,"(CONTRACTS OF 125,000 SWISS FRANCS)"
06/04/2004,CHF,1.2898,-0.66%,-0.0066,0.17,-0.86,44331,4369,17197,0,29519,10281,33888,27478,10443,16853,"(CONTRACTS OF 125,000 SWISS FRANCS)"
30/03/2004,CHF,1.2813,-1.80%,-0.0179,0.14,-0.86,34701,3894,8514,3,21309,12818,25206,21335,9495,13366,"(CONTRACTS OF 125,000 SWISS FRANCS)"
23/03/2004,CHF,1.2586,1.55%,0.0156,0.18,-0.83,32617,4130,6992,3,18303,13174,22436,20169,10181,12448,"(CONTRACTS OF 125,000 SWISS FRANCS)"
16/03/2004,CHF,1.2784,0.25%,0.0025,0.18,-0.84,36981,3351,12674,3,23287,9529,26641,22206,10340,14775,"(CONTRACTS OF 125,000 SWISS FRANCS)"
09/03/2004,CHF,1.2816,1.03%,0.0103,0.11,-0.88,52178,3624,18397,18,36792,16795,40434,35210,11744,16968,"(CONTRACTS OF 125,000 SWISS FRANCS)"
02/03/2004,CHF,1.2949,-4.33%,-0.0424,0.18,-0.83,47795,5518,16298,182,29915,16128,35615,32608,12180,15187,"(CONTRACTS OF 125,000 SWISS FRANCS)"
24/02/2004,CHF,1.2412,-1.14%,-0.0113,0.19,-0.82,41521,12608,7234,8,12572,22681,25188,29923,16333,11598,"(CONTRACTS OF 125,000 SWISS FRANCS)"
17/02/2004,CHF,1.2272,0.68%,0.0068,0.13,-0.87,46002,19558,8079,23,7781,28215,27362,36317,18640,9685,"(CONTRACTS OF 125,000 SWISS FRANCS)"
10/02/2004,CHF,1.2356,1.18%,0.0119,0.13,-0.91,43840,18974,7971,23,8146,25510,27143,33504,16697,10336,"(CONTRACTS OF 125,000 SWISS FRANCS)"
03/02/2004,CHF,1.2504,-0.84%,-0.0084,0.13,-0.91,40899,15234,5791,21,10742,24438,25997,30250,14902,10649,"(CONTRACTS OF 125,000 SWISS FRANCS)"
27/01/2004,CHF,1.24,0.55%,0.0055,0.16,-0.87,41836,18388,5409,12,6586,26611,24986,32032,16850,9804,"(CONTRACTS OF 125,000 SWISS FRANCS)"
20/01/2004,CHF,1.2469,-2.12%,-0.021,0.16,-0.88,41755,13858,4826,12,9024,25761,22894,30599,18861,11156,"(CONTRACTS OF 125,000 SWISS FRANCS)"
13/01/2004,CHF,1.221,0.84%,0.0084,0.15,-0.89,48588,19826,4553,9,6792,33222,26627,37784,21961,10804,"(CONTRACTS OF 125,000 SWISS FRANCS)"
06/01/2004,CHF,1.2313,1.47%,0.0148,0.16,-0.9,50231,21198,4993,9,4842,35703,26049,40705,24182,9526,"(CONTRACTS OF 125,000 SWISS FRANCS)"
30/12/2003,CHF,1.2497,0.66%,0.0066,0.19,-0.86,48615,21637,4854,9,5131,34889,26777,39752,21838,8863,"(CONTRACTS OF 125,000 SWISS FRANCS)"
22/12/2003,CHF,1.258,0.10%,0.001,0.14,-0.94,44642,16287,4655,9,6338,32403,22634,37067,22008,7575,"(CONTRACTS OF 125,000 SWISS FRANCS)"
16/12/2003,CHF,1.2593,0.17%,0.0017,0.21,-0.88,43835,17217,3963,10,4574,32500,21801,36473,22034,7362,"(CONTRACTS OF 125,000 SWISS FRANCS)"
09/12/2003,CHF,1.2615,2.01%,0.0203,0.19,-0.88,84218,16850,4499,9,38050,64146,54909,68654,29309,15564,"(CONTRACTS OF 125,000 SWISS FRANCS)"
02/12/2003,CHF,1.2874,2.36%,0.0239,0.19,-0.88,71273,13276,4818,13,34119,57843,47408,62674,23865,8599,"(CONTRACTS OF 125,000 SWISS FRANCS)"
25/11/2003,CHF,1.3185,-1.96%,-0.0194,0.13,-0.91,66856,10303,5422,13,35714,52800,46030,58235,20826,8621,"(CONTRACTS OF 125,000 SWISS FRANCS)"
18/11/2003,CHF,1.2932,5.10%,0.0523,0.18,-0.89,65394,11879,8928,5,33877,47901,45761,56834,19633,8560,"(CONTRACTS OF 125,000 SWISS FRANCS)"
11/11/2003,CHF,1.3627,-0.15%,-0.0015,0.13,-0.93,61432,2352,18074,76,45453,30333,47881,48483,13551,12949,"(CONTRACTS OF 125,000 SWISS FRANCS)"
04/11/2003,CHF,1.3606,-2.19%,-0.0216,0.18,-0.87,55727,8075,10369,76,34878,34091,43029,44536,12698,11191,"(CONTRACTS OF 125,000 SWISS FRANCS)"
28/10/2003,CHF,1.3315,-0.14%,-0.0014,0.18,-0.88,58372,20403,7304,13,16930,40657,37346,47974,21026,10398,"(CONTRACTS OF 125,000 SWISS FRANCS)"
21/10/2003,CHF,1.3296,-0.96%,-0.0095,0.12,-0.93,56476,20045,8652,10,18171,38654,38226,47316,18250,9160,"(CONTRACTS OF 125,000 SWISS FRANCS)"
14/10/2003,CHF,1.317,-0.07%,-0.0007,0.11,-0.93,54575,21627,6729,12,12877,38699,34516,45440,20059,9135,"(CONTRACTS OF 125,000 SWISS FRANCS)"
07/10/2003,CHF,1.3161,0.08%,0.0008,0.12,-0.91,47583,14236,7170,10,14533,31001,28779,38181,18804,9402,"(CONTRACTS OF 125,000 SWISS FRANCS)"
30/09/2003,CHF,1.3172,2.98%,0.0302,0.12,-0.91,43199,10464,8877,36,15822,24856,26322,33769,16877,9430,"(CONTRACTS OF 125,000 SWISS FRANCS)"
23/09/2003,CHF,1.3576,2.27%,0.023,0.1,-0.93,39097,3883,13386,19,26706,13190,30608,26595,8489,12502,"(CONTRACTS OF 125,000 SWISS FRANCS)"
16/09/2003,CHF,1.3892,-0.83%,-0.0083,0.1,-0.93,43853,600,20534,8,35304,7272,35912,27814,7941,16039,"(CONTRACTS OF 125,000 SWISS FRANCS)"
09/09/2003,CHF,1.3777,2.92%,0.0297,0.19,-0.85,69919,2134,18238,0,53104,28804,55238,47042,14681,22877,"(CONTRACTS OF 125,000 SWISS FRANCS)"
02/09/2003,CHF,1.4192,-0.49%,-0.0049,0.17,-0.88,62339,2179,22268,0,49084,18014,51263,40282,11076,22057,"(CONTRACTS OF 125,000 SWISS FRANCS)"
26/08/2003,CHF,1.4123,-1.74%,-0.0173,0.14,-0.87,59642,2669,22045,0,45441,16736,48110,38781,11532,20861,"(CONTRACTS OF 125,000 SWISS FRANCS)"
19/08/2003,CHF,1.3881,-1.48%,-0.0147,0.12,-0.9,55803,2032,21829,450,43443,15622,45925,37901,9878,17902,"(CONTRACTS OF 125,000 SWISS FRANCS)"
12/08/2003,CHF,1.3678,-1.55%,-0.0154,0.18,-0.85,43172,1556,11558,0,32109,19937,33665,31495,9507,11677,"(CONTRACTS OF 125,000 SWISS FRANCS)"
05/08/2003,CHF,1.3469,0.38%,0.0039,0.15,-0.87,43306,1082,9538,0,31220,22379,32302,31917,11004,11389,"(CONTRACTS OF 125,000 SWISS FRANCS)"
29/07/2003,CHF,1.3521,0.74%,0.0074,0.22,-0.81,44007,1984,10124,10,30865,22102,32859,32236,11148,11771,"(CONTRACTS OF 125,000 SWISS FRANCS)"
22/07/2003,CHF,1.3622,1.74%,0.0175,0.22,-0.79,42920,1855,10880,0,30541,17973,32396,28853,10524,14067,"(CONTRACTS OF 125,000 SWISS FRANCS)"
15/07/2003,CHF,1.3863,-1.31%,-0.013,0.13,-0.87,41283,3194,12046,0,28585,15218,31779,27264,9504,14019,"(CONTRACTS OF 125,000 SWISS FRANCS)"
08/07/2003,CHF,1.3684,-1.94%,-0.0192,0.14,-0.87,38622,3140,9239,19,26150,16885,29309,26143,9313,12479,"(CONTRACTS OF 125,000 SWISS FRANCS)"
01/07/2003,CHF,1.3424,-1.01%,-0.01,0.14,-0.87,38413,6909,6530,21,18312,22729,25242,29280,13171,9133,"(CONTRACTS OF 125,000 SWISS FRANCS)"
24/06/2003,CHF,1.329,-1.52%,-0.0151,0.14,-0.74,38511,12193,3698,144,8359,26500,20696,30342,17815,8169,"(CONTRACTS OF 125,000 SWISS FRANCS)"
17/06/2003,CHF,1.3091,0.58%,0.0059,0.14,-0.79,43746,20750,2971,40,3172,33349,23962,36360,19784,7386,"(CONTRACTS OF 125,000 SWISS FRANCS)"
10/06/2003,CHF,1.3168,-0.45%,-0.0045,0.12,-0.92,66764,19468,3328,461,21106,51868,41035,55657,25729,11107,"(CONTRACTS OF 125,000 SWISS FRANCS)"
03/06/2003,CHF,1.3109,-1.86%,-0.0184,0.22,-0.95,56747,20431,4382,456,13378,44612,34265,49450,22482,7297,"(CONTRACTS OF 125,000 SWISS FRANCS)"
27/05/2003,CHF,1.287,0.28%,0.0028,0.14,-1.06,57565,22826,2039,460,10072,48053,33358,50552,24207,7013,"(CONTRACTS OF 125,000 SWISS FRANCS)"
20/05/2003,CHF,1.2906,1.77%,0.0179,0.14,-0.98,56731,22261,4272,481,10360,45287,33102,50040,23629,6691,"(CONTRACTS OF 125,000 SWISS FRANCS)"
13/05/2003,CHF,1.3139,0.76%,0.0077,0.15,-1.03,53657,19927,4301,480,11110,42753,31517,47534,22140,6123,"(CONTRACTS OF 125,000 SWISS FRANCS)"
06/05/2003,CHF,1.324,2.78%,0.0282,0.24,-0.9,48748,19122,5631,480,11134,37611,30736,43722,18012,5026,"(CONTRACTS OF 125,000 SWISS FRANCS)"
29/04/2003,CHF,1.3619,0.66%,0.0067,0.17,-1.05,39583,6251,6577,481,18341,24449,25073,31507,14510,8076,"(CONTRACTS OF 125,000 SWISS FRANCS)"
22/04/2003,CHF,1.371,1.52%,0.0153,0.17,-1.04,38778,6280,8333,486,21253,20728,28019,29547,10759,9231,"(CONTRACTS OF 125,000 SWISS FRANCS)"
15/04/2003,CHF,1.3922,-0.39%,-0.0039,0.16,-1.07,37084,3703,5132,459,22123,20190,26285,25781,10799,11303,"(CONTRACTS OF 125,000 SWISS FRANCS)"
08/04/2003,CHF,1.3868,-2.45%,-0.0242,0.18,-0.98,36072,3574,4794,459,21260,19568,25293,24821,10779,11251,"(CONTRACTS OF 125,000 SWISS FRANCS)"
01/04/2003,CHF,1.3537,2.12%,0.0214,0.17,-0.97,33917,5945,3957,455,15293,22225,21693,26637,12224,7280,"(CONTRACTS OF 125,000 SWISS FRANCS)"
25/03/2003,CHF,1.383,-0.02%,-0.0002,0.25,-0.95,32336,5094,5537,478,17806,17115,23378,23130,8958,9206,"(CONTRACTS OF 125,000 SWISS FRANCS)"
18/03/2003,CHF,1.3827,-4.10%,-0.0401,0.18,-0.99,32564,7649,2617,478,10831,21496,18958,24591,13606,7973,"(CONTRACTS OF 125,000 SWISS FRANCS)"
11/03/2003,CHF,1.3283,0.79%,0.0079,0.24,-0.87,76795,22469,1650,471,28986,65893,51926,68014,24869,8781,"(CONTRACTS OF 125,000 SWISS FRANCS)"
04/03/2003,CHF,1.3389,1.41%,0.0142,0.5,-0.73,65297,21912,1684,454,18104,56250,40470,58388,24827,6909,"(CONTRACTS OF 125,000 SWISS FRANCS)"
25/02/2003,CHF,1.358,1.29%,0.013,0.51,-0.72,56247,18644,2801,68,14237,47121,32949,49990,23298,6257,"(CONTRACTS OF 125,000 SWISS FRANCS)"
18/02/2003,CHF,1.3758,-0.65%,-0.0065,0.53,-0.72,55430,17243,2737,26,16002,45177,33271,47940,22159,7490,"(CONTRACTS OF 125,000 SWISS FRANCS)"
11/02/2003,CHF,1.3669,-1.49%,-0.0148,0.51,-0.75,57566,21871,1584,46,11826,47802,33743,49432,23823,8134,"(CONTRACTS OF 125,000 SWISS FRANCS)"
04/02/2003,CHF,1.3468,0.78%,0.0078,0.46,-0.78,62069,29146,3400,32,6493,51237,35671,54669,26398,7400,"(CONTRACTS OF 125,000 SWISS FRANCS)"
28/01/2003,CHF,1.3574,0.39%,0.0039,0.54,-0.7,57912,27506,2042,41,6381,49033,33928,51116,23984,6796,"(CONTRACTS OF 125,000 SWISS FRANCS)"
21/01/2003,CHF,1.3627,1.70%,0.0171,0.53,-0.71,60220,29457,2778,33,3938,49422,33428,52233,26792,7987,"(CONTRACTS OF 125,000 SWISS FRANCS)"
14/01/2003,CHF,1.3862,0.93%,0.0093,0.55,-0.73,54413,26106,3076,32,2222,44057,28360,47165,26053,7248,"(CONTRACTS OF 125,000 SWISS FRANCS)"
07/01/2003,CHF,1.3992,-0.96%,-0.0096,0.55,-0.74,51474,24392,1342,31,1912,43428,26335,44801,25139,6673,"(CONTRACTS OF 125,000 SWISS FRANCS)"
31/12/2002,CHF,1.3859,2.29%,0.0232,0.49,-0.79,50293,24829,1576,80,1558,41529,26467,43185,23826,7108,"(CONTRACTS OF 125,000 SWISS FRANCS)"
23/12/2002,CHF,1.4184,0.52%,0.0052,0.52,-0.86,48996,23980,2157,33,1963,40324,25976,42514,23020,6482,"(CONTRACTS OF 125,000 SWISS FRANCS)"
17/12/2002,CHF,1.4258,2.37%,0.024,0.6,-0.74,45822,21932,2737,47,1837,37075,23816,39859,22006,5963,"(CONTRACTS OF 125,000 SWISS FRANCS)"
10/12/2002,CHF,1.4604,1.13%,0.0114,0.61,-0.73,56438,12617,3584,694,22789,43719,36100,47997,20338,8441,"(CONTRACTS OF 125,000 SWISS FRANCS)"
03/12/2002,CHF,1.4771,0.42%,0.0042,0.65,-0.7,41297,8857,3549,22,12739,29755,21618,33326,19679,7971,"(CONTRACTS OF 125,000 SWISS FRANCS)"
26/11/2002,CHF,1.4833,-1.37%,-0.0136,0.67,-0.68,39113,9482,3475,23,10802,26997,20307,30495,18806,8618,"(CONTRACTS OF 125,000 SWISS FRANCS)"
19/11/2002,CHF,1.4633,-1.36%,-0.0135,0.65,-0.69,51854,18695,3568,40,8188,40200,26923,43808,24931,8046,"(CONTRACTS OF 125,000 SWISS FRANCS)"
12/11/2002,CHF,1.4437,1.31%,0.0131,0.62,-0.72,54699,20436,3195,21,8208,43183,28665,46399,26034,8300,"(CONTRACTS OF 125,000 SWISS FRANCS)"
05/11/2002,CHF,1.4628,1.81%,0.0182,0.65,-0.87,46457,15086,4536,12,7650,33062,22748,37610,23709,8847,"(CONTRACTS OF 125,000 SWISS FRANCS)"
29/10/2002,CHF,1.4897,0.78%,0.0078,0.65,-1.02,39726,7172,5495,20,17638,23843,24830,29358,14896,10368,"(CONTRACTS OF 125,000 SWISS FRANCS)"
22/10/2002,CHF,1.5014,-0.52%,-0.0052,0.61,-1.12,34064,1589,7744,20,19236,14076,20845,21840,13219,12224,"(CONTRACTS OF 125,000 SWISS FRANCS)"
15/10/2002,CHF,1.4936,0.29%,0.0029,0.67,-1.03,34794,3441,6439,28,15804,17762,19273,24229,15521,10565,"(CONTRACTS OF 125,000 SWISS FRANCS)"
08/10/2002,CHF,1.4979,-0.71%,-0.0071,0.61,-1.04,32344,2931,6525,29,15126,15207,18086,21761,14258,10583,"(CONTRACTS OF 125,000 SWISS FRANCS)"
01/10/2002,CHF,1.4873,0.23%,0.0024,0.58,-1.1,34820,7551,5446,23,10858,20283,18432,25752,16388,9068,"(CONTRACTS OF 125,000 SWISS FRANCS)"
24/09/2002,CHF,1.4908,1.09%,0.0109,0.62,-1.09,29978,3208,6282,31,11823,14151,15062,20464,14916,9514,"(CONTRACTS OF 125,000 SWISS FRANCS)"
17/09/2002,CHF,1.5072,-0.68%,-0.0068,0.66,-1.07,31372,1841,7745,152,15145,11380,17138,19277,14234,12095,"(CONTRACTS OF 125,000 SWISS FRANCS)"
10/09/2002,CHF,1.497,-1.82%,-0.0181,0.65,-1.08,45547,12296,2062,929,14298,33608,27523,36599,18024,8948,"(CONTRACTS OF 125,000 SWISS FRANCS)"
03/09/2002,CHF,1.4702,1.49%,0.015,0.66,-1.07,43187,12597,1666,5,14017,35722,26619,37393,16568,5794,"(CONTRACTS OF 125,000 SWISS FRANCS)"
27/08/2002,CHF,1.4924,0.48%,0.0048,0.66,-1.07,41038,10848,909,3,16383,33127,27234,34039,13804,6999,"(CONTRACTS OF 125,000 SWISS FRANCS)"
20/08/2002,CHF,1.4996,-0.96%,-0.0096,0.73,-0.96,37675,8139,1916,6,14899,28234,23044,30156,14631,7519,"(CONTRACTS OF 125,000 SWISS FRANCS)"
13/08/2002,CHF,1.4853,1.53%,0.0154,0.77,-0.86,36637,8339,787,6,14557,30441,22902,31234,13735,5403,"(CONTRACTS OF 125,000 SWISS FRANCS)"
06/08/2002,CHF,1.5084,-1.78%,-0.0177,0.67,-1.04,40136,8571,2084,22,15086,30599,23679,32705,16457,7431,"(CONTRACTS OF 125,000 SWISS FRANCS)"
30/07/2002,CHF,1.482,-0.88%,-0.0088,0.73,-1.01,38202,8888,729,13,10896,32140,19797,32882,18405,5320,"(CONTRACTS OF 125,000 SWISS FRANCS)"
23/07/2002,CHF,1.469,-1.37%,-0.0136,1.01,-0.7,43471,13114,0,0,8830,36726,21944,36726,21527,6745,"(CONTRACTS OF 125,000 SWISS FRANCS)"
16/07/2002,CHF,1.4492,2.23%,0.0226,1.12,-0.65,43504,14649,564,0,5243,37458,19892,38022,23612,5482,"(CONTRACTS OF 125,000 SWISS FRANCS)"
09/07/2002,CHF,1.4823,0.28%,0.0028,1.11,-0.65,40306,13414,1016,62,4609,33851,18085,34929,22221,5377,"(CONTRACTS OF 125,000 SWISS FRANCS)"
02/07/2002,CHF,1.4865,0.73%,0.0073,1.11,-0.66,41514,14447,1274,108,4420,34447,18975,35829,22539,5685,"(CONTRACTS OF 125,000 SWISS FRANCS)"
25/06/2002,CHF,1.4974,3.39%,0.0345,1.13,-0.65,42093,16138,1618,80,2688,33329,18906,35027,23187,7066,"(CONTRACTS OF 125,000 SWISS FRANCS)"
18/06/2002,CHF,1.55,0.32%,0.0032,1.21,-0.57,41808,16830,2430,0,1869,32460,18699,34890,23109,6918,"(CONTRACTS OF 125,000 SWISS FRANCS)"
11/06/2002,CHF,1.555,0.63%,0.0063,1.17,-0.61,61771,15115,2640,0,20647,52339,35762,54979,26009,6792,"(CONTRACTS OF 125,000 SWISS FRANCS)"
04/06/2002,CHF,1.5649,0.55%,0.0055,1.14,-0.65,54699,14226,4204,117,15165,44817,29508,49138,25191,5561,"(CONTRACTS OF 125,000 SWISS FRANCS)"
28/05/2002,CHF,1.5736,0.24%,0.0024,1.21,-0.59,55255,15620,3632,4,11986,45690,27610,49326,27645,5929,"(CONTRACTS OF 125,000 SWISS FRANCS)"
21/05/2002,CHF,1.5774,2.27%,0.0229,1.18,-0.62,54273,17652,3831,0,11015,44360,28667,48191,25606,6082,"(CONTRACTS OF 125,000 SWISS FRANCS)"
14/05/2002,CHF,1.614,-1.63%,-0.0162,1.22,-0.59,53559,16917,3602,0,12631,43491,29548,47093,24011,6466,"(CONTRACTS OF 125,000 SWISS FRANCS)"
07/05/2002,CHF,1.5881,1.78%,0.018,1.2,-0.56,55906,19765,4091,0,9825,46750,29590,50841,26316,5065,"(CONTRACTS OF 125,000 SWISS FRANCS)"
30/04/2002,CHF,1.6169,1.99%,0.0201,1.46,-0.35,53449,19662,4555,0,9264,43645,28926,48200,24523,5249,"(CONTRACTS OF 125,000 SWISS FRANCS)"
23/04/2002,CHF,1.6498,0.84%,0.0084,1.49,-0.34,43483,13604,6834,11,8869,31592,22484,38437,20999,5046,"(CONTRACTS OF 125,000 SWISS FRANCS)"
16/04/2002,CHF,1.6637,0.09%,0.0009,1.51,-0.35,32812,6948,10465,14,10919,16627,17881,27106,14931,5706,"(CONTRACTS OF 125,000 SWISS FRANCS)"
09/04/2002,CHF,1.6652,-0.13%,-0.0013,1.53,-0.34,30241,4164,10704,14,10360,13036,14538,23754,15703,6487,"(CONTRACTS OF 125,000 SWISS FRANCS)"
02/04/2002,CHF,1.663,0.29%,0.0029,1.5,-0.42,34709,8992,10733,13,10011,17859,19016,28605,15693,6104,"(CONTRACTS OF 125,000 SWISS FRANCS)"
26/03/2002,CHF,1.6678,-0.59%,-0.0059,1.62,-0.32,33558,6042,10299,3,11234,15423,17279,25725,16279,7833,"(CONTRACTS OF 125,000 SWISS FRANCS)"
19/03/2002,CHF,1.658,1.15%,0.0116,1.62,-0.32,31147,3593,10148,0,10982,13942,14575,24090,16572,7057,"(CONTRACTS OF 125,000 SWISS FRANCS)"
12/03/2002,CHF,1.6773,0.89%,0.009,1.65,-0.25,54877,3056,11092,9,39555,31457,42620,42558,12257,12319,"(CONTRACTS OF 125,000 SWISS FRANCS)"
05/03/2002,CHF,1.6924,0.91%,0.0092,1.68,-0.14,45641,1825,14770,0,35746,14220,37571,28990,8070,16651,"(CONTRACTS OF 125,000 SWISS FRANCS)"
26/02/2002,CHF,1.708,-1.24%,-0.0123,1.62,-0.19,44593,3343,18242,0,34624,9778,37967,28020,6626,16573,"(CONTRACTS OF 125,000 SWISS FRANCS)"
19/02/2002,CHF,1.6871,-0.06%,-0.0006,1.6,-0.21,43256,4406,16636,8,29656,10229,34070,26873,9186,16383,"(CONTRACTS OF 125,000 SWISS FRANCS)"
12/02/2002,CHF,1.6861,0.65%,0.0065,1.63,-0.17,42496,2406,16732,0,32683,9643,35089,26375,7407,16121,"(CONTRACTS OF 125,000 SWISS FRANCS)"
05/02/2002,CHF,1.6971,0.14%,0.0014,1.56,-0.25,44628,2042,15999,0,35015,9097,37057,25096,7571,19532,"(CONTRACTS OF 125,000 SWISS FRANCS)"
29/01/2002,CHF,1.6994,-2.31%,-0.0229,1.61,-0.16,46672,1943,20313,6,37636,9040,39585,29359,7087,17313,"(CONTRACTS OF 125,000 SWISS FRANCS)"
22/01/2002,CHF,1.661,0.60%,0.0061,1.64,-0.08,33536,4710,8656,0,20565,12754,25275,21410,8261,12126,"(CONTRACTS OF 125,000 SWISS FRANCS)"
15/01/2002,CHF,1.6711,-0.94%,-0.0093,1.64,0.01,35162,2837,11857,0,24865,9883,27702,21740,7460,13422,"(CONTRACTS OF 125,000 SWISS FRANCS)"
08/01/2002,CHF,1.6556,1.18%,0.0118,1.66,-0.09,27704,2120,7985,0,17060,9025,19180,17010,8524,10694,"(CONTRACTS OF 125,000 SWISS FRANCS)"
28/12/2001,CHF,1.6753,-1.32%,-0.0132,1.7,-0.06,34855,2139,11578,0,22654,7869,24793,19447,10062,15408,"(CONTRACTS OF 125,000 SWISS FRANCS)"
21/12/2001,CHF,1.6534,-1.26%,-0.0125,1.8,-0.07,31069,7322,5072,0,8411,15193,15733,20265,15336,10804,"(CONTRACTS OF 125,000 SWISS FRANCS)"
18/12/2001,CHF,1.6329,1.19%,0.0119,1.83,-0.03,34232,10882,3749,0,5935,24475,16817,28224,17415,6008,"(CONTRACTS OF 125,000 SWISS FRANCS)"
11/12/2001,CHF,1.6525,0.02%,0.0002,1.83,0.04,56869,4786,5252,1083,38225,40119,44094,46454,12775,10415,"(CONTRACTS OF 125,000 SWISS FRANCS)"
04/12/2001,CHF,1.6529,0.19%,0.0019,1.9,0.09,51077,6330,6535,0,30764,36430,37094,42965,13983,8112,"(CONTRACTS OF 125,000 SWISS FRANCS)"
27/11/2001,CHF,1.656,-0.43%,-0.0043,2.02,0.01,53351,6369,10953,0,34599,31765,40968,42718,12383,10633,"(CONTRACTS OF 125,000 SWISS FRANCS)"
20/11/2001,CHF,1.6489,1.28%,0.0129,2.05,0.01,51800,8473,8234,0,30171,34464,38644,42698,13156,9102,"(CONTRACTS OF 125,000 SWISS FRANCS)"
13/11/2001,CHF,1.6703,-1.54%,-0.0153,1.97,0.07,55854,12389,7170,49,29719,37628,42157,44847,13697,11007,"(CONTRACTS OF 125,000 SWISS FRANCS)"
06/11/2001,CHF,1.645,-1.26%,-0.0125,2.04,0.1,53393,15330,3294,43,19495,44210,34868,47547,18525,5846,"(CONTRACTS OF 125,000 SWISS FRANCS)"
30/10/2001,CHF,1.6245,2.16%,0.0219,2.04,-0.02,52732,16826,4397,26,17018,42306,33870,46729,18862,6003,"(CONTRACTS OF 125,000 SWISS FRANCS)"
23/10/2001,CHF,1.6604,-1.58%,-0.0157,2.1,-0.18,49156,14717,5274,31,18990,35778,33738,41083,15418,8073,"(CONTRACTS OF 125,000 SWISS FRANCS)"
16/10/2001,CHF,1.6346,-0.59%,-0.0059,2.07,-0.27,47839,17914,953,23,12415,41521,30352,42497,17487,5342,"(CONTRACTS OF 125,000 SWISS FRANCS)"
09/10/2001,CHF,1.625,-0.35%,-0.0035,2.06,-0.28,48135,18420,1338,23,7611,39154,26054,40515,22081,7620,"(CONTRACTS OF 125,000 SWISS FRANCS)"
02/10/2001,CHF,1.6194,-2.01%,-0.0199,2.17,-0.27,48429,18013,855,23,7162,41851,25198,42729,23231,5700,"(CONTRACTS OF 125,000 SWISS FRANCS)"
25/09/2001,CHF,1.5875,0.57%,0.0057,2.06,-0.36,48890,19377,1038,23,4669,42519,24069,43580,24821,5310,"(CONTRACTS OF 125,000 SWISS FRANCS)"
18/09/2001,CHF,1.5966,2.68%,0.0271,2.61,-0.21,49670,22112,444,23,4766,43159,26901,43626,22769,6044,"(CONTRACTS OF 125,000 SWISS FRANCS)"
10/09/2001,CHF,1.6405,3.71%,0.0378,2.9,-0.35,67436,17375,2609,193,23705,49775,41273,52577,26163,14859,"(CONTRACTS OF 125,000 SWISS FRANCS)"
04/09/2001,CHF,1.7037,-2.49%,-0.0246,3.08,-0.34,63213,18879,3517,29,22541,50733,41449,54279,21764,8934,"(CONTRACTS OF 125,000 SWISS FRANCS)"
28/08/2001,CHF,1.6623,-0.51%,-0.0051,3.02,-0.34,64979,21578,1399,30,18614,56578,40222,58007,24757,6972,"(CONTRACTS OF 125,000 SWISS FRANCS)"
21/08/2001,CHF,1.6538,1.52%,0.0153,3.03,-0.4,63620,21545,842,35,24044,62060,45624,62937,17996,683,"(CONTRACTS OF 125,000 SWISS FRANCS)"
14/08/2001,CHF,1.6793,2.22%,0.0224,2.99,-0.44,60467,20155,3024,36,23954,55500,44145,58560,16322,1907,"(CONTRACTS OF 125,000 SWISS FRANCS)"
07/08/2001,CHF,1.7174,0.50%,0.005,3.1,-0.47,55078,16351,5352,59,19002,40055,35412,45466,19666,9612,"(CONTRACTS OF 125,000 SWISS FRANCS)"
31/07/2001,CHF,1.726,-0.19%,-0.0019,3.13,-0.48,51045,12633,5964,62,19951,36293,32646,42319,18399,8726,"(CONTRACTS OF 125,000 SWISS FRANCS)"
24/07/2001,CHF,1.7228,1.70%,0.0171,3.11,-0.51,52242,11660,6833,69,20764,34661,32493,41563,19749,10679,"(CONTRACTS OF 125,000 SWISS FRANCS)"
17/07/2001,CHF,1.7526,1.43%,0.0144,3.15,-0.48,49243,2508,20626,108,31135,14154,33751,34888,15492,14355,"(CONTRACTS OF 125,000 SWISS FRANCS)"
10/07/2001,CHF,1.778,0.95%,0.0095,3.14,-0.55,57247,2254,28572,75,42304,7808,44633,36455,12614,20792,"(CONTRACTS OF 125,000 SWISS FRANCS)"
03/07/2001,CHF,1.795,-1.75%,-0.0173,3.12,-0.7,59127,2215,30630,43,47591,7631,49849,38304,9278,20823,"(CONTRACTS OF 125,000 SWISS FRANCS)"
26/06/2001,CHF,1.7642,1.40%,0.0141,3.12,-0.54,45280,1837,19198,43,32748,8201,34628,27442,10652,17838,"(CONTRACTS OF 125,000 SWISS FRANCS)"
19/06/2001,CHF,1.7893,-0.08%,-0.0008,3.16,-0.48,44886,2256,20748,43,33688,5190,35987,25981,8899,18905,"(CONTRACTS OF 125,000 SWISS FRANCS)"
12/06/2001,CHF,1.7878,-0.64%,-0.0064,3.03,-0.78,78819,3713,25482,43,64665,26570,68421,52095,10398,26724,"(CONTRACTS OF 125,000 SWISS FRANCS)"
05/06/2001,CHF,1.7764,0.30%,0.003,3.11,-0.7,59218,3395,26737,86,45895,13385,49376,40208,9842,19010,"(CONTRACTS OF 125,000 SWISS FRANCS)"
29/05/2001,CHF,1.7818,-0.81%,-0.0081,3.03,-0.87,57880,2901,26605,43,45591,12383,48535,39031,9345,18849,"(CONTRACTS OF 125,000 SWISS FRANCS)"
22/05/2001,CHF,1.7675,-1.36%,-0.0136,3.12,-0.79,57644,3002,27345,43,46215,10371,49260,37759,8384,19885,"(CONTRACTS OF 125,000 SWISS FRANCS)"
15/05/2001,CHF,1.7437,-0.14%,-0.0014,3.05,-0.89,55039,3493,25490,0,42745,11369,46238,36859,8801,18180,"(CONTRACTS OF 125,000 SWISS FRANCS)"
08/05/2001,CHF,1.7412,-0.89%,-0.0089,3.03,-0.91,51497,1674,22098,0,40640,12205,42314,34303,9183,17194,"(CONTRACTS OF 125,000 SWISS FRANCS)"
01/05/2001,CHF,1.7258,-0.71%,-0.0071,3.08,-1.1,46595,457,21145,43,37616,12275,38116,33463,8479,13132,"(CONTRACTS OF 125,000 SWISS FRANCS)"
24/04/2001,CHF,1.7136,0.83%,0.0083,3.01,-1.23,43310,274,18296,0,32299,14423,32573,32719,10737,10591,"(CONTRACTS OF 125,000 SWISS FRANCS)"
17/04/2001,CHF,1.7279,-0.66%,-0.0066,3.2,-1.46,41101,257,17002,44,30299,13204,30600,30250,10501,10851,"(CONTRACTS OF 125,000 SWISS FRANCS)"
10/04/2001,CHF,1.7166,-0.88%,-0.0088,3.21,-1.47,40762,752,16313,36,30452,11016,31240,27365,9522,13397,"(CONTRACTS OF 125,000 SWISS FRANCS)"
03/04/2001,CHF,1.7016,0.93%,0.0094,3.2,-1.58,40219,860,16176,28,28368,10757,29256,26961,10963,13258,"(CONTRACTS OF 125,000 SWISS FRANCS)"
27/03/2001,CHF,1.7176,-1.78%,-0.0176,3.26,-1.54,42018,900,15931,33,30918,12009,31851,27973,10167,14045,"(CONTRACTS OF 125,000 SWISS FRANCS)"
20/03/2001,CHF,1.6876,-0.31%,-0.0031,3.28,-1.5,38504,1352,15982,30,24997,10094,26379,26106,12125,12398,"(CONTRACTS OF 125,000 SWISS FRANCS)"
13/03/2001,CHF,1.6824,-2.09%,-0.0207,3.35,-1.52,48823,6135,8053,130,27570,29073,33835,37256,14988,11567,"(CONTRACTS OF 125,000 SWISS FRANCS)"
06/03/2001,CHF,1.648,1.69%,0.017,3.35,-1.67,44450,5879,5683,27,21387,29749,27293,35459,17157,8991,"(CONTRACTS OF 125,000 SWISS FRANCS)"
27/02/2001,CHF,1.6763,0.43%,0.0043,3.36,-1.59,41691,3293,5385,28,23294,25929,26615,31342,15076,10349,"(CONTRACTS OF 125,000 SWISS FRANCS)"
20/02/2001,CHF,1.6835,-0.92%,-0.0092,3.41,-1.89,41578,2548,3881,28,22438,26048,25014,29957,16564,11621,"(CONTRACTS OF 125,000 SWISS FRANCS)"
13/02/2001,CHF,1.6681,-0.77%,-0.0076,3.42,-1.89,45106,10124,2537,0,17335,33234,27459,35771,17647,9335,"(CONTRACTS OF 125,000 SWISS FRANCS)"
06/02/2001,CHF,1.6554,-0.60%,-0.0059,3.38,-1.97,46904,11447,3022,5,16113,35157,27565,38184,19339,8720,"(CONTRACTS OF 125,000 SWISS FRANCS)"
30/01/2001,CHF,1.6456,-0.83%,-0.0083,3.35,-2.07,51103,13453,2616,24,16408,40186,29885,42826,21218,8277,"(CONTRACTS OF 125,000 SWISS FRANCS)"
23/01/2001,CHF,1.632,0.20%,0.002,3.37,-2.14,52944,15721,2053,48,16489,41417,32258,43518,20686,9426,"(CONTRACTS OF 125,000 SWISS FRANCS)"
16/01/2001,CHF,1.6352,-1.40%,-0.0139,3.32,-2.37,49883,15468,2155,53,13912,39557,29433,41765,20450,8118,"(CONTRACTS OF 125,000 SWISS FRANCS)"
09/01/2001,CHF,1.6126,-0.71%,-0.0071,3.37,-2.14,48022,14003,2044,5,11610,40550,25618,42599,22404,5423,"(CONTRACTS OF 125,000 SWISS FRANCS)"
02/01/2001,CHF,1.6012,1.97%,0.0199,3.27,-2.9,47926,13683,2197,151,12104,38345,25938,40693,21988,7233,"(CONTRACTS OF 125,000 SWISS FRANCS)"
26/12/2000,CHF,1.6334,2.89%,0.0293,3.36,-2.98,43449,13366,2212,89,12284,36546,25739,38847,17710,4602,"(CONTRACTS OF 125,000 SWISS FRANCS)"
19/12/2000,CHF,1.682,1.82%,0.0184,3.25,-3.16,40067,12627,3787,21,10291,30433,22939,34241,17128,5826,"(CONTRACTS OF 125,000 SWISS FRANCS)"
12/12/2000,CHF,1.7132,0.08%,0.0008,3.33,-3.14,64186,12326,3237,25,33391,49871,45742,53133,18444,11053,"(CONTRACTS OF 125,000 SWISS FRANCS)"
05/12/2000,CHF,1.7146,2.67%,0.027,3.32,-3.22,55840,8363,3238,794,33092,43293,42249,47325,13591,8515,"(CONTRACTS OF 125,000 SWISS FRANCS)"
28/11/2000,CHF,1.7616,2.36%,0.0239,3.43,-3.25,49675,1275,12438,55,35874,21848,37204,34341,12471,15334,"(CONTRACTS OF 125,000 SWISS FRANCS)"
21/11/2000,CHF,1.8042,-1.77%,-0.0175,3.45,-3.21,49098,1236,15936,53,40271,16578,41560,32567,7538,16531,"(CONTRACTS OF 125,000 SWISS FRANCS)"
14/11/2000,CHF,1.7729,-0.31%,-0.0031,3.38,-3.27,48360,1684,14101,0,37479,19112,39163,33213,9197,15147,"(CONTRACTS OF 125,000 SWISS FRANCS)"
07/11/2000,CHF,1.7674,1.65%,0.0166,3.31,-3.35,48949,1000,14199,0,37474,15987,38474,30186,10475,18763,"(CONTRACTS OF 125,000 SWISS FRANCS)"
31/10/2000,CHF,1.797,0.04%,0.0004,3.33,-3.32,51334,524,17817,0,41607,13106,42131,30923,9203,20411,"(CONTRACTS OF 125,000 SWISS FRANCS)"
24/10/2000,CHF,1.7978,-1.70%,-0.0168,3.32,-3.32,49114,181,18186,0,40248,11548,40429,29734,8685,19380,"(CONTRACTS OF 125,000 SWISS FRANCS)"
17/10/2000,CHF,1.7678,-1.42%,-0.0141,3.43,-3.18,48582,181,17693,0,39927,13486,40108,31179,8474,17403,"(CONTRACTS OF 125,000 SWISS FRANCS)"
10/10/2000,CHF,1.7431,-0.65%,-0.0065,3.44,-3.22,44566,1924,15817,0,33248,13815,35172,29632,9394,14934,"(CONTRACTS OF 125,000 SWISS FRANCS)"
03/10/2000,CHF,1.7318,-0.42%,-0.0042,3.48,-3.23,42626,1611,16943,0,31280,12208,32891,29151,9735,13475,"(CONTRACTS OF 125,000 SWISS FRANCS)"
26/09/2000,CHF,1.7246,2.88%,0.0293,3.33,-3.22,43443,1211,16988,0,32418,10317,33629,27305,9814,16138,"(CONTRACTS OF 125,000 SWISS FRANCS)"
19/09/2000,CHF,1.7758,-0.61%,-0.0061,3.32,-3.26,47704,710,23091,0,38927,5011,39637,28102,8067,19602,"(CONTRACTS OF 125,000 SWISS FRANCS)"
12/09/2000,CHF,1.765,-1.17%,-0.0116,3.36,-3.24,67266,0,22852,0,57150,22852,57150,45704,10116,21562,"(CONTRACTS OF 125,000 SWISS FRANCS)"
05/09/2000,CHF,1.7446,-0.68%,-0.0067,3.38,-3.21,60790,35,21899,53,49997,13268,50085,35220,10705,25570,"(CONTRACTS OF 125,000 SWISS FRANCS)"
29/08/2000,CHF,1.7329,0.33%,0.0033,3.35,-3.23,54174,0,21678,72,44410,11471,44482,33221,9692,20953,"(CONTRACTS OF 125,000 SWISS FRANCS)"
22/08/2000,CHF,1.7387,-1.65%,-0.0164,3.37,-3.23,55008,17,21507,18,45877,12336,45912,33861,9096,21147,"(CONTRACTS OF 125,000 SWISS FRANCS)"
15/08/2000,CHF,1.7104,0.05%,0.0005,3.31,-3.25,51065,465,17384,19,41572,15035,42056,32438,9009,18627,"(CONTRACTS OF 125,000 SWISS FRANCS)"
08/08/2000,CHF,1.7112,-1.33%,-0.0132,3.27,-3.3,49510,456,17451,35,38782,14484,39273,31970,10237,17540,"(CONTRACTS OF 125,000 SWISS FRANCS)"
01/08/2000,CHF,1.6888,-2.17%,-0.0214,3.31,-3.32,37775,2059,4966,11,23326,19262,25396,24239,12379,13536,"(CONTRACTS OF 125,000 SWISS FRANCS)"
25/07/2000,CHF,1.653,1.30%,0.013,3.25,-3.38,38246,1956,4316,11,22169,21014,24136,25341,14110,12905,"(CONTRACTS OF 125,000 SWISS FRANCS)"
18/07/2000,CHF,1.6747,-2.91%,-0.0287,3.4,-3.25,39293,6858,5472,1,19656,20613,26515,26086,12778,13207,"(CONTRACTS OF 125,000 SWISS FRANCS)"
11/07/2000,CHF,1.6274,0.30%,0.003,3.35,-3.28,35282,10607,1147,0,7919,26098,18526,27245,16756,8037,"(CONTRACTS OF 125,000 SWISS FRANCS)"
05/07/2000,CHF,1.6323,0.15%,0.0015,3.37,-3.28,36413,8702,0,0,9222,28684,17924,28684,18489,7729,"(CONTRACTS OF 125,000 SWISS FRANCS)"
27/06/2000,CHF,1.6348,-0.40%,-0.004,3.3,-3.37,32663,8015,0,0,7237,23700,15252,23700,17411,8963,"(CONTRACTS OF 125,000 SWISS FRANCS)"
20/06/2000,CHF,1.6283,0.02%,0.0002,3.32,-3.36,35076,10376,0,0,2248,29186,12624,29186,22452,5890,"(CONTRACTS OF 125,000 SWISS FRANCS)"
13/06/2000,CHF,1.6286,1.03%,0.0103,3.15,-3.6,48130,10451,1506,0,17600,34574,28051,36080,20079,12050,"(CONTRACTS OF 125,000 SWISS FRANCS)"
06/06/2000,CHF,1.6455,2.41%,0.0244,3.01,-3.69,40281,2740,5164,143,23235,25279,26118,30586,14163,9695,"(CONTRACTS OF 125,000 SWISS FRANCS)"
30/05/2000,CHF,1.6862,2.07%,0.0209,3.03,-3.79,43436,1659,11935,121,27862,16852,29642,28908,13794,14528,"(CONTRACTS OF 125,000 SWISS FRANCS)"
23/05/2000,CHF,1.7218,-0.02%,-0.0002,3.03,-3.74,47495,1061,19046,15,36577,9734,37653,28795,9842,18700,"(CONTRACTS OF 125,000 SWISS FRANCS)"
16/05/2000,CHF,1.7214,-0.41%,-0.0041,3.06,-3.9,44802,513,19745,15,32564,7558,33092,27318,11710,17484,"(CONTRACTS OF 125,000 SWISS FRANCS)"
09/05/2000,CHF,1.7144,-0.06%,-0.0006,2.97,-3.68,46044,1827,22566,15,34535,8101,36377,30682,9667,15362,"(CONTRACTS OF 125,000 SWISS FRANCS)"
02/05/2000,CHF,1.7134,-0.33%,-0.0033,3.1,-3.42,44747,1491,20164,20,33609,7604,35120,27788,9627,16959,"(CONTRACTS OF 125,000 SWISS FRANCS)"
25/04/2000,CHF,1.7077,-2.51%,-0.0248,2.9,-3.32,44731,1775,19394,20,33770,7894,35565,27308,9166,17423,"(CONTRACTS OF 125,000 SWISS FRANCS)"
18/04/2000,CHF,1.6659,-1.49%,-0.0148,2.8,-3.37,41355,2771,16245,191,27001,10198,29963,26634,11392,14721,"(CONTRACTS OF 125,000 SWISS FRANCS)"
11/04/2000,CHF,1.6414,-0.13%,-0.0013,2.71,-3.51,40415,3735,13363,191,22340,14339,26266,27893,14149,12522,"(CONTRACTS OF 125,000 SWISS FRANCS)"
04/04/2000,CHF,1.6392,0.98%,0.0098,2.75,-3.47,39166,3885,13560,121,22044,12380,26050,26061,13116,13105,"(CONTRACTS OF 125,000 SWISS FRANCS)"
28/03/2000,CHF,1.6554,1.01%,0.0102,2.75,-3.44,39624,3079,14645,229,24093,10767,27401,25641,12223,13983,"(CONTRACTS OF 125,000 SWISS FRANCS)"
21/03/2000,CHF,1.6723,-0.50%,-0.005,2.38,-3.78,48014,895,28498,37,39788,2637,40720,31172,7294,16842,"(CONTRACTS OF 125,000 SWISS FRANCS)"
14/03/2000,CHF,1.664,0.62%,0.0062,2.43,-3.7,46462,869,25943,38,37319,4253,38226,30234,8236,16228,"(CONTRACTS OF 125,000 SWISS FRANCS)"
07/03/2000,CHF,1.6744,-0.62%,-0.0062,2.22,-3.83,73487,1798,28066,368,61042,26069,63208,54503,10279,18984,"(CONTRACTS OF 125,000 SWISS FRANCS)"
29/02/2000,CHF,1.6641,-3.89%,-0.0382,2.4,-3.65,69567,1703,28415,27,58398,23825,60128,52267,9439,17300,"(CONTRACTS OF 125,000 SWISS FRANCS)"
22/02/2000,CHF,1.6018,2.11%,0.0213,2.16,-3.84,68268,5776,24513,0,46161,30201,51937,54714,16331,13554,"(CONTRACTS OF 125,000 SWISS FRANCS)"
15/02/2000,CHF,1.6363,-0.33%,-0.0033,2.37,-3.59,69682,2726,30313,0,55946,20421,58672,50734,11010,18948,"(CONTRACTS OF 125,000 SWISS FRANCS)"
08/02/2000,CHF,1.6309,1.50%,0.0151,2.25,-3.8,70946,1905,33431,0,59192,19529,61097,52960,9849,17986,"(CONTRACTS OF 125,000 SWISS FRANCS)"
01/02/2000,CHF,1.6557,-2.77%,-0.0274,2.05,-4,68474,981,33394,0,60177,15840,61158,49234,7316,19240,"(CONTRACTS OF 125,000 SWISS FRANCS)"
25/01/2000,CHF,1.611,-1.22%,-0.0121,1.84,-4.12,60956,3530,24041,0,50103,18663,53633,42704,7323,18252,"(CONTRACTS OF 125,000 SWISS FRANCS)"
18/01/2000,CHF,1.5916,-2.16%,-0.0213,1.74,-4.25,57549,9553,19560,6,42112,21877,51671,41443,5878,16106,"(CONTRACTS OF 125,000 SWISS FRANCS)"
11/01/2000,CHF,1.558,-0.18%,-0.0018,1.63,-4.25,49828,10610,10664,18,27730,25832,38358,36514,11470,13314,"(CONTRACTS OF 125,000 SWISS FRANCS)"
04/01/2000,CHF,1.5552,2.45%,0.0248,1.68,-4.37,43280,3924,13839,14,28663,15242,32601,29095,10679,14185,"(CONTRACTS OF 125,000 SWISS FRANCS)"
28/12/1999,CHF,1.5943,-0.46%,-0.0046,2,-4,44834,3680,17035,0,35503,13386,39183,30421,5651,14413,"(CONTRACTS OF 125,000 SWISS FRANCS)"
21/12/1999,CHF,1.587,0.19%,0.002,1.97,-4.23,43769,3574,15360,12,33882,12632,37468,28004,6301,15765,"(CONTRACTS OF 125,000 SWISS FRANCS)"
14/12/1999,CHF,1.5901,-1.94%,-0.0192,1.89,-4.21,46156,3187,15913,85,36707,10672,39979,26670,6177,19486,"(CONTRACTS OF 125,000 SWISS FRANCS)"
07/12/1999,CHF,1.5598,1.72%,0.0174,1.9,-4.18,88422,4902,23083,0,72035,44156,76937,67239,11485,21183,"(CONTRACTS OF 125,000 SWISS FRANCS)"
30/11/1999,CHF,1.5871,-2.01%,-0.0199,1.78,-4.25,73971,9811,32543,0,57323,21783,67134,54326,6837,19645,"(CONTRACTS OF 125,000 SWISS FRANCS)"
23/11/1999,CHF,1.5559,0.00%,0,1.95,-4.05,70368,6986,27940,34,56213,22872,63233,50846,7135,19522,"(CONTRACTS OF 125,000 SWISS FRANCS)"
16/11/1999,CHF,1.5559,-0.69%,-0.0068,1.85,-4.17,70282,6425,25822,141,55463,25545,62029,51508,8253,18774,"(CONTRACTS OF 125,000 SWISS FRANCS)"
09/11/1999,CHF,1.5453,-1.22%,-0.0121,1.89,-4.07,66209,7878,24497,151,48725,24330,56754,48978,9455,17231,"(CONTRACTS OF 125,000 SWISS FRANCS)"
02/11/1999,CHF,1.5267,-1.09%,-0.0108,2.16,-3.94,57593,16429,5236,248,30689,41030,47366,46514,10227,11079,"(CONTRACTS OF 125,000 SWISS FRANCS)"
26/10/1999,CHF,1.5103,-2.84%,-0.028,2.1,-4.07,66055,34793,1214,9,18155,55404,52957,56627,13098,9428,"(CONTRACTS OF 125,000 SWISS FRANCS)"
19/10/1999,CHF,1.4686,0.62%,0.0062,2.24,-3.88,77098,48332,3688,0,10409,69522,58741,73210,18357,3888,"(CONTRACTS OF 125,000 SWISS FRANCS)"
12/10/1999,CHF,1.4778,0.21%,0.0021,1.97,-4.16,61768,31090,5759,143,13907,50349,45140,56251,16628,5517,"(CONTRACTS OF 125,000 SWISS FRANCS)"
05/10/1999,CHF,1.4809,2.68%,0.0272,2.02,-4.06,52712,17308,6614,71,19800,40034,37179,46719,15533,5993,"(CONTRACTS OF 125,000 SWISS FRANCS)"
28/09/1999,CHF,1.5217,0.31%,0.0031,1.15,-4.2,46310,6355,13939,27,28909,19146,35291,33112,11019,13198,"(CONTRACTS OF 125,000 SWISS FRANCS)"
21/09/1999,CHF,1.5265,1.36%,0.0137,1.16,-4.29,42875,5941,16362,27,27328,12732,33296,29121,9579,13754,"(CONTRACTS OF 125,000 SWISS FRANCS)"
14/09/1999,CHF,1.5475,-2.48%,-0.0245,0.97,-4.48,39524,6552,10146,384,23985,10971,30921,21501,8603,18023,"(CONTRACTS OF 125,000 SWISS FRANCS)"
07/09/1999,CHF,1.51,0.26%,0.0026,0.94,-4.48,83443,21796,8734,0,50504,63991,72300,72725,11143,10718,"(CONTRACTS OF 125,000 SWISS FRANCS)"
31/08/1999,CHF,1.514,0.28%,0.0028,1.01,-4.43,75421,17718,10376,0,42052,48896,59770,59272,15651,16149,"(CONTRACTS OF 125,000 SWISS FRANCS)"
24/08/1999,CHF,1.5183,0.43%,0.0043,0.98,-4.47,74192,21155,11694,28,39645,44850,60828,56572,13364,17620,"(CONTRACTS OF 125,000 SWISS FRANCS)"
17/08/1999,CHF,1.5248,-1.90%,-0.0189,1,-4.41,70619,21493,9938,0,36143,46770,57636,56708,12983,13911,"(CONTRACTS OF 125,000 SWISS FRANCS)"
10/08/1999,CHF,1.4963,0.01%,0.0001,1.04,-4.38,71229,25467,8372,0,27259,50239,52726,58611,18503,12618,"(CONTRACTS OF 125,000 SWISS FRANCS)"
03/08/1999,CHF,1.4965,0.55%,0.0055,1.03,-4.26,68452,23162,8024,0,31586,50292,54748,58316,13704,10136,"(CONTRACTS OF 125,000 SWISS FRANCS)"
27/07/1999,CHF,1.5048,2.38%,0.0241,0.97,-4.31,62785,16415,8919,1461,36586,41184,54462,51564,8323,11221,"(CONTRACTS OF 125,000 SWISS FRANCS)"
20/07/1999,CHF,1.5415,2.25%,0.0228,1.02,-4.19,64112,4720,38121,0,49428,12940,54148,51061,9964,13051,"(CONTRACTS OF 125,000 SWISS FRANCS)"
13/07/1999,CHF,1.577,-0.74%,-0.0074,1.1,-4.11,68746,3081,39765,340,59011,8668,62432,48773,6314,19973,"(CONTRACTS OF 125,000 SWISS FRANCS)"
06/07/1999,CHF,1.5654,-0.99%,-0.0099,1.17,-4.04,70429,2595,42832,302,60513,7752,63410,50886,7019,19543,"(CONTRACTS OF 125,000 SWISS FRANCS)"
29/06/1999,CHF,1.55,-0.30%,-0.003,1.09,-4.1,62864,1091,37974,162,54770,5552,56023,43688,6841,19176,"(CONTRACTS OF 125,000 SWISS FRANCS)"
22/06/1999,CHF,1.5453,-0.99%,-0.0098,1.03,-4.1,61728,1754,36481,0,55070,5620,56824,42101,4904,19627,"(CONTRACTS OF 125,000 SWISS FRANCS)"
15/06/1999,CHF,1.5302,-0.57%,-0.0057,0.97,-4.15,60005,1560,35052,85,51552,6141,53197,41278,6808,18727,"(CONTRACTS OF 125,000 SWISS FRANCS)"
08/06/1999,CHF,1.5215,0.14%,0.0014,0.88,-4.15,93143,1400,36991,5,81601,33521,83006,70517,10137,22626,"(CONTRACTS OF 125,000 SWISS FRANCS)"
01/06/1999,CHF,1.5237,-1.70%,-0.0168,0.88,-4.1,78503,820,34555,245,68193,21083,69258,55883,9245,22620,"(CONTRACTS OF 125,000 SWISS FRANCS)"
25/05/1999,CHF,1.4983,0.05%,0.0005,0.87,-4.06,72256,1730,32345,306,61462,22118,63498,54769,8758,17487,"(CONTRACTS OF 125,000 SWISS FRANCS)"
18/05/1999,CHF,1.499,0.20%,0.002,0.9,-4.04,72148,1137,44487,634,61147,10648,62918,55769,9230,16379,"(CONTRACTS OF 125,000 SWISS FRANCS)"
11/05/1999,CHF,1.502,0.62%,0.0062,0.87,-4,69202,2026,40213,0,59634,10852,61660,51065,7542,18137,"(CONTRACTS OF 125,000 SWISS FRANCS)"
04/05/1999,CHF,1.5113,-0.27%,-0.0027,0.84,-4.03,79764,2081,54553,0,68061,7675,70142,62228,9622,17536,"(CONTRACTS OF 125,000 SWISS FRANCS)"
27/04/1999,CHF,1.5072,0.01%,0.0001,0.87,-3.99,72793,1308,46645,0,64078,7557,65386,54202,7407,18591,"(CONTRACTS OF 125,000 SWISS FRANCS)"
20/04/1999,CHF,1.5073,-1.16%,-0.0115,0.88,-4.06,69739,920,40832,0,60929,7749,61849,48581,7890,21158,"(CONTRACTS OF 125,000 SWISS FRANCS)"
13/04/1999,CHF,1.49,-1.06%,-0.0105,0.94,-4,61762,400,34887,132,54478,7060,55010,42079,6752,19683,"(CONTRACTS OF 125,000 SWISS FRANCS)"
06/04/1999,CHF,1.4744,1.03%,0.0103,1.08,-3.79,60305,250,34356,517,51522,9117,52289,43990,8016,16315,"(CONTRACTS OF 125,000 SWISS FRANCS)"
30/03/1999,CHF,1.4897,-2.24%,-0.0222,1.11,-3.83,65132,848,37178,115,57448,10219,58411,47512,6721,17620,"(CONTRACTS OF 125,000 SWISS FRANCS)"
23/03/1999,CHF,1.457,-0.19%,-0.0019,1.11,-3.76,59773,1580,33725,365,50566,9477,52511,43567,7262,16206,"(CONTRACTS OF 125,000 SWISS FRANCS)"
16/03/1999,CHF,1.4542,0.80%,0.0081,1.17,-3.72,58225,653,32740,385,50720,8310,51758,41435,6467,16790,"(CONTRACTS OF 125,000 SWISS FRANCS)"
09/03/1999,CHF,1.466,-0.65%,-0.0065,1.22,-3.66,77118,3058,32031,778,64372,21987,68208,54796,8910,22322,"(CONTRACTS OF 125,000 SWISS FRANCS)"
02/03/1999,CHF,1.4565,-0.64%,-0.0064,1.25,-3.69,62783,2252,29841,100,53481,12882,55833,42823,6950,19960,"(CONTRACTS OF 125,000 SWISS FRANCS)"
23/02/1999,CHF,1.4472,-1.50%,-0.0149,1.13,-3.74,58818,4265,27807,551,47514,13889,52330,42247,6488,16571,"(CONTRACTS OF 125,000 SWISS FRANCS)"
16/02/1999,CHF,1.4258,-0.62%,-0.0062,1.13,-3.76,58906,2360,20588,2407,46217,16722,50984,39717,7922,19189,"(CONTRACTS OF 125,000 SWISS FRANCS)"
09/02/1999,CHF,1.417,-0.28%,-0.0028,1.16,-3.75,57841,2049,19588,1899,45435,16635,49383,38122,8458,19719,"(CONTRACTS OF 125,000 SWISS FRANCS)"
02/02/1999,CHF,1.413,-1.73%,-0.0171,1.16,-3.75,55423,1856,17649,1731,41051,18194,44638,37574,10785,17849,"(CONTRACTS OF 125,000 SWISS FRANCS)"
26/01/1999,CHF,1.389,-0.98%,-0.0098,1.1,-3.74,39925,9612,7493,543,20018,18700,30173,26736,9752,13189,"(CONTRACTS OF 125,000 SWISS FRANCS)"
19/01/1999,CHF,1.3755,0.76%,0.0076,1.11,-3.72,39551,9619,4776,743,15841,20268,26203,25787,13348,13764,"(CONTRACTS OF 125,000 SWISS FRANCS)"
12/01/1999,CHF,1.386,-1.13%,-0.0112,1.19,-3.75,34499,5154,5639,775,18316,13647,24245,20061,10254,14438,"(CONTRACTS OF 125,000 SWISS FRANCS)"
05/01/1999,CHF,1.3705,-0.17%,-0.0017,1.19,-3.74,28162,6156,2865,813,11809,15811,18778,19489,9384,8673,"(CONTRACTS OF 125,000 SWISS FRANCS)"
29/12/1998,CHF,1.3682,-0.38%,-0.0038,1.55,-3.63,27894,9645,2526,765,7581,16548,17991,19839,9903,8055,"(CONTRACTS OF 125,000 SWISS FRANCS)"
22/12/1998,CHF,1.363,-1.56%,-0.0155,1.39,-3.73,34227,10816,2472,990,6992,17767,18798,21229,15429,12998,"(CONTRACTS OF 125,000 SWISS FRANCS)"
15/12/1998,CHF,1.342,1.41%,0.0142,1.38,-3.84,35533,14153,2922,822,4217,22016,19192,25760,16341,9773,"(CONTRACTS OF 125,000 SWISS FRANCS)"
08/12/1998,CHF,1.3612,1.47%,0.0148,1.38,-3.77,56017,4207,11573,6271,32947,23726,43425,41570,12592,14447,"(CONTRACTS OF 125,000 SWISS FRANCS)"
01/12/1998,CHF,1.3815,1.76%,0.0178,1.56,-3.69,53014,1250,13396,208,37102,19042,38560,32646,14454,20368,"(CONTRACTS OF 125,000 SWISS FRANCS)"
24/11/1998,CHF,1.4063,-2.35%,-0.0232,1.5,-3.72,48642,6472,10750,469,32258,19287,39199,30506,9443,18136,"(CONTRACTS OF 125,000 SWISS FRANCS)"
17/11/1998,CHF,1.374,0.88%,0.0088,1.38,-3.8,37992,6114,5176,220,22676,21873,29010,27269,8982,10723,"(CONTRACTS OF 125,000 SWISS FRANCS)"
10/11/1998,CHF,1.3862,-2.06%,-0.0204,1.5,-3.81,43526,6102,9056,229,27437,21190,33768,30475,9758,13051,"(CONTRACTS OF 125,000 SWISS FRANCS)"
03/11/1998,CHF,1.3582,-0.98%,-0.0098,1.12,-4.17,47107,20220,2894,229,13107,35271,33556,38394,13551,8713,"(CONTRACTS OF 125,000 SWISS FRANCS)"
27/10/1998,CHF,1.345,0.00%,0,1.16,-3.99,53439,25213,2377,615,9771,39949,35599,42941,17840,10498,"(CONTRACTS OF 125,000 SWISS FRANCS)"
20/10/1998,CHF,1.345,-1.74%,-0.0172,1.25,-3.87,55397,27237,2778,0,8669,42371,35906,45149,19491,10248,"(CONTRACTS OF 125,000 SWISS FRANCS)"
13/10/1998,CHF,1.322,1.31%,0.0132,1.18,-4.13,57595,27815,1938,0,8826,46651,36641,48589,20954,9006,"(CONTRACTS OF 125,000 SWISS FRANCS)"
06/10/1998,CHF,1.3395,3.42%,0.0348,1.34,-3.88,65316,31097,4472,0,8561,49489,39658,53961,25658,11355,"(CONTRACTS OF 125,000 SWISS FRANCS)"
29/09/1998,CHF,1.387,0.18%,0.0018,1.44,-3.81,61231,29785,3716,0,6943,45119,36728,48835,24503,12396,"(CONTRACTS OF 125,000 SWISS FRANCS)"
22/09/1998,CHF,1.3895,0.41%,0.0041,1.38,-3.99,60636,31485,4176,9,5784,45207,37278,49392,23358,11244,"(CONTRACTS OF 125,000 SWISS FRANCS)"
15/09/1998,CHF,1.3952,1.61%,0.0162,1.48,-3.9,62729,29363,4162,9,6037,45171,35409,49342,27320,13387,"(CONTRACTS OF 125,000 SWISS FRANCS)"
08/09/1998,CHF,1.418,1.80%,0.0182,1.56,-3.9,107698,30246,2568,567,47161,86565,77974,89700,29724,17998,"(CONTRACTS OF 125,000 SWISS FRANCS)"
01/09/1998,CHF,1.444,3.96%,0.0404,1.52,-3.98,94728,29181,2577,1265,37809,74509,68255,78351,26473,16377,"(CONTRACTS OF 125,000 SWISS FRANCS)"
25/08/1998,CHF,1.5035,0.42%,0.0042,1.65,-3.91,71062,6626,11476,0,55811,41840,62437,53316,8625,17746,"(CONTRACTS OF 125,000 SWISS FRANCS)"
18/08/1998,CHF,1.5098,-1.40%,-0.0139,1.74,-3.82,71898,6800,12946,0,55879,40725,62679,53671,9219,18227,"(CONTRACTS OF 125,000 SWISS FRANCS)"
11/08/1998,CHF,1.489,-0.15%,-0.0015,1.72,-3.91,63325,3636,9825,0,46920,38791,50556,48616,12769,14709,"(CONTRACTS OF 125,000 SWISS FRANCS)"
04/08/1998,CHF,1.4868,0.13%,0.0013,1.9,-3.69,69201,1633,10274,0,48731,39737,50364,50011,18837,19190,"(CONTRACTS OF 125,000 SWISS FRANCS)"
28/07/1998,CHF,1.4888,1.40%,0.0141,1.9,-3.69,71653,1969,21997,0,55724,31145,57693,53142,13960,18511,"(CONTRACTS OF 125,000 SWISS FRANCS)"
21/07/1998,CHF,1.51,0.61%,0.0061,2.02,-3.57,89621,1419,30479,0,66910,24780,68329,55259,21292,34362,"(CONTRACTS OF 125,000 SWISS FRANCS)"
14/07/1998,CHF,1.5193,0.57%,0.0057,2.06,-3.5,94364,1866,34717,0,70993,23439,72859,58156,21505,36208,"(CONTRACTS OF 125,000 SWISS FRANCS)"
07/07/1998,CHF,1.528,-0.43%,-0.0043,1.96,-3.6,91984,667,37105,0,77004,21619,77671,58724,14313,33260,"(CONTRACTS OF 125,000 SWISS FRANCS)"
30/06/1998,CHF,1.5215,-1.12%,-0.0111,2.04,-3.55,84479,0,34301,300,73247,21164,73547,55765,10932,28714,"(CONTRACTS OF 125,000 SWISS FRANCS)"
23/06/1998,CHF,1.5047,-0.58%,-0.0058,1.93,-3.64,72377,0,25380,95,61411,22614,61506,48089,10871,24288,"(CONTRACTS OF 125,000 SWISS FRANCS)"
16/06/1998,CHF,1.496,-1.36%,-0.0135,1.83,-3.73,67989,489,23470,96,58059,23051,58644,46617,9345,21372,"(CONTRACTS OF 125,000 SWISS FRANCS)"
09/06/1998,CHF,1.476,0.24%,0.0024,1.92,-3.64,74877,14228,7697,638,44354,55360,59220,63695,15657,11182,"(CONTRACTS OF 125,000 SWISS FRANCS)"
02/06/1998,CHF,1.4795,-0.65%,-0.0064,1.65,-3.91,71639,13718,7445,589,41339,52280,55646,60314,15993,11325,"(CONTRACTS OF 125,000 SWISS FRANCS)"
26/05/1998,CHF,1.47,0.49%,0.005,1.69,-3.9,72306,18612,7505,386,35053,53108,54051,60999,18255,11307,"(CONTRACTS OF 125,000 SWISS FRANCS)"
19/05/1998,CHF,1.4773,0.18%,0.0018,1.44,-4.12,58490,3952,12446,302,43153,30849,47407,43597,11083,14893,"(CONTRACTS OF 125,000 SWISS FRANCS)"
12/05/1998,CHF,1.48,-0.10%,-0.001,1.49,-4.07,60383,4650,11941,367,39682,31457,44699,43765,15684,16618,"(CONTRACTS OF 125,000 SWISS FRANCS)"
05/05/1998,CHF,1.4785,1.00%,0.0101,1.3,-4.26,58017,3184,15856,442,42721,23859,46347,40157,11670,17860,"(CONTRACTS OF 125,000 SWISS FRANCS)"
28/04/1998,CHF,1.4935,-0.78%,-0.0077,1.44,-4.19,66632,912,15234,337,46599,23735,47848,39306,18784,27326,"(CONTRACTS OF 125,000 SWISS FRANCS)"
21/04/1998,CHF,1.482,0.68%,0.0069,1.15,-4.41,64856,1533,16399,555,43963,20623,46051,37577,18805,27279,"(CONTRACTS OF 125,000 SWISS FRANCS)"
14/04/1998,CHF,1.4922,2.05%,0.0208,1.28,-4.28,63175,1996,21233,695,48662,16282,51353,38210,11822,24965,"(CONTRACTS OF 125,000 SWISS FRANCS)"
07/04/1998,CHF,1.5235,-0.03%,-0.0003,1.5,-4.06,72115,1037,31051,442,63259,15348,64738,46841,7377,25274,"(CONTRACTS OF 125,000 SWISS FRANCS)"
31/03/1998,CHF,1.523,-2.23%,-0.022,1.31,-4.28,74057,2830,29834,442,59407,11597,62679,41873,11378,32184,"(CONTRACTS OF 125,000 SWISS FRANCS)"
24/03/1998,CHF,1.4898,-0.73%,-0.0073,1.33,-4.23,63405,2313,26044,442,51008,10038,53763,36524,9642,26881,"(CONTRACTS OF 125,000 SWISS FRANCS)"
17/03/1998,CHF,1.479,0.68%,0.0069,0.94,-4.62,54332,1139,19164,453,45236,11697,46828,31314,7504,23018,"(CONTRACTS OF 125,000 SWISS FRANCS)"
10/03/1998,CHF,1.4892,-1.43%,-0.0142,0.92,-4.58,82166,692,23297,1026,72621,33305,74339,57628,7827,24538,"(CONTRACTS OF 125,000 SWISS FRANCS)"
03/03/1998,CHF,1.4682,-1.22%,-0.0121,1.23,-4.3,47038,1128,14445,499,35890,14893,37517,29837,9521,17201,"(CONTRACTS OF 125,000 SWISS FRANCS)"
24/02/1998,CHF,1.4505,1.49%,0.0151,0.77,-4.76,46437,1191,13446,588,30694,16333,32473,30367,13964,16070,"(CONTRACTS OF 125,000 SWISS FRANCS)"
17/02/1998,CHF,1.4725,-0.80%,-0.008,0.85,-4.65,46246,263,14485,568,37717,14080,38548,29133,7698,17113,"(CONTRACTS OF 125,000 SWISS FRANCS)"
10/02/1998,CHF,1.4608,0.18%,0.0018,1.02,-4.48,44914,263,13606,567,35981,14449,36811,28622,8103,16292,"(CONTRACTS OF 125,000 SWISS FRANCS)"
03/02/1998,CHF,1.4635,-1.02%,-0.0102,1.12,-4.36,48339,859,13668,1162,37344,13339,39365,28169,8974,20170,"(CONTRACTS OF 125,000 SWISS FRANCS)"
27/01/1998,CHF,1.4487,3.10%,0.0315,1.12,-4.4,50597,525,15047,441,36656,13224,37622,28712,12975,21885,"(CONTRACTS OF 125,000 SWISS FRANCS)"
20/01/1998,CHF,1.495,-1.16%,-0.0116,1.21,-4.29,68283,570,29028,588,60456,10815,61614,40431,6669,27852,"(CONTRACTS OF 125,000 SWISS FRANCS)"
13/01/1998,CHF,1.4778,0.15%,0.0015,1.15,-4.35,57346,565,22840,588,51084,10054,52237,33482,5109,23864,"(CONTRACTS OF 125,000 SWISS FRANCS)"
06/01/1998,CHF,1.48,-1.84%,-0.0183,1.37,-4.25,59190,978,21761,588,50058,11052,51624,33401,7566,25789,"(CONTRACTS OF 125,000 SWISS FRANCS)"
30/12/1997,CHF,1.4532,-1.37%,-0.0136,1.31,-4.37,43497,585,16468,588,34455,9252,35628,26308,7869,17189,"(CONTRACTS OF 125,000 SWISS FRANCS)"
23/12/1997,CHF,1.4335,0.45%,0.0045,1.45,-4.33,37379,609,13171,644,25845,10115,27098,23930,10281,13449,"(CONTRACTS OF 125,000 SWISS FRANCS)"
16/12/1997,CHF,1.44,0.89%,0.009,1.47,1.47,37024,599,14036,680,26805,9288,28084,24004,8940,13020,"(CONTRACTS OF 125,000 SWISS FRANCS)"
09/12/1997,CHF,1.453,-1.36%,-0.0135,1.56,1.56,64895,768,18599,715,54215,26847,55698,46161,9197,18734,"(CONTRACTS OF 125,000 SWISS FRANCS)"
02/12/1997,CHF,1.4335,-1.65%,-0.0164,1.63,-4.23,52555,15325,4202,1767,18764,30965,35856,36934,16699,15621,"(CONTRACTS OF 125,000 SWISS FRANCS)"
25/11/1997,CHF,1.4102,-0.41%,-0.0041,1.88,-3.87,50947,18926,1942,1222,13976,35722,34124,38886,16823,12061,"(CONTRACTS OF 125,000 SWISS FRANCS)"
18/11/1997,CHF,1.4045,-0.97%,-0.0097,2.32,-3.43,52691,19845,2607,1224,14524,37621,35593,41452,17098,11239,"(CONTRACTS OF 125,000 SWISS FRANCS)"
11/11/1997,CHF,1.391,0.89%,0.0089,1.75,-3.93,54686,19559,3391,1181,16150,39814,36890,44386,17796,10300,"(CONTRACTS OF 125,000 SWISS FRANCS)"
04/11/1997,CHF,1.4035,1.44%,0.0145,1.77,-3.91,49711,14439,2326,1182,16661,33927,32282,37435,17429,12276,"(CONTRACTS OF 125,000 SWISS FRANCS)"
28/10/1997,CHF,1.424,4.35%,0.0444,1.88,-3.72,49413,12446,2270,1156,16854,28226,30456,31652,18957,17761,"(CONTRACTS OF 125,000 SWISS FRANCS)"
21/10/1997,CHF,1.4887,-1.90%,-0.0188,1.89,-3.79,44265,8592,6946,981,21990,16146,31563,24073,12702,20192,"(CONTRACTS OF 125,000 SWISS FRANCS)"
14/10/1997,CHF,1.461,-0.87%,-0.0087,1.66,-3.99,40797,17338,3755,922,8715,22607,26975,27284,13822,13513,"(CONTRACTS OF 125,000 SWISS FRANCS)"
07/10/1997,CHF,1.4484,-0.08%,-0.0008,1.46,-4.1,44432,19328,3341,920,8097,29016,28345,33277,16087,11155,"(CONTRACTS OF 125,000 SWISS FRANCS)"
30/09/1997,CHF,1.4473,1.54%,0.0156,1.5,-4.2,37371,14184,3393,792,8195,21805,23171,25990,14200,11381,"(CONTRACTS OF 125,000 SWISS FRANCS)"
23/09/1997,CHF,1.47,-1.31%,-0.013,1.25,-4.33,38341,13477,5006,607,8524,20648,22608,26261,15733,12080,"(CONTRACTS OF 125,000 SWISS FRANCS)"
16/09/1997,CHF,1.451,2.42%,0.0245,1.34,-4.09,39128,12724,4485,602,9742,20636,23068,25723,16060,13405,"(CONTRACTS OF 125,000 SWISS FRANCS)"
09/09/1997,CHF,1.487,1.33%,0.0134,1.41,-4.15,59626,5796,14563,1070,37783,23738,44649,39371,14977,20255,"(CONTRACTS OF 125,000 SWISS FRANCS)"
02/09/1997,CHF,1.507,-1.55%,-0.0154,1.28,-4.36,55135,4343,15397,1377,39138,18063,44858,34837,10277,20298,"(CONTRACTS OF 125,000 SWISS FRANCS)"
26/08/1997,CHF,1.484,2.01%,0.0203,1.43,-4.17,56028,4724,15279,1291,36688,17065,42703,33635,13325,22393,"(CONTRACTS OF 125,000 SWISS FRANCS)"
19/08/1997,CHF,1.5145,0.75%,0.0076,1.4,-4.06,54892,3503,18671,1283,41038,12370,45824,32324,9068,22568,"(CONTRACTS OF 125,000 SWISS FRANCS)"
12/08/1997,CHF,1.526,0.52%,0.0052,1.18,-4.44,56799,2481,19682,1278,43558,11563,47317,32523,9482,24276,"(CONTRACTS OF 125,000 SWISS FRANCS)"
05/08/1997,CHF,1.534,-1.07%,-0.0106,1.37,-4.21,65465,1915,24137,1268,54238,10373,57421,35778,8044,29687,"(CONTRACTS OF 125,000 SWISS FRANCS)"
29/07/1997,CHF,1.5178,-2.35%,-0.0232,1.48,-4.08,64402,2542,23776,1268,50863,9826,54673,34870,9729,29532,"(CONTRACTS OF 125,000 SWISS FRANCS)"
22/07/1997,CHF,1.483,-0.68%,-0.0068,1.37,-4.22,56391,2781,20536,1137,44141,9412,48059,31085,8332,25306,"(CONTRACTS OF 125,000 SWISS FRANCS)"
15/07/1997,CHF,1.473,-0.48%,-0.0048,1.34,-4.16,54829,2091,18819,1059,41433,9157,44583,29035,10246,25794,"(CONTRACTS OF 125,000 SWISS FRANCS)"
08/07/1997,CHF,1.466,0.00%,0,1.34,-4.28,53110,1448,21741,452,42230,9307,44130,31500,8980,21610,"(CONTRACTS OF 125,000 SWISS FRANCS)"
01/07/1997,CHF,1.466,-1.95%,-0.0193,1.35,-4.33,42570,2211,15066,332,28838,9625,31381,25023,11189,17547,"(CONTRACTS OF 125,000 SWISS FRANCS)"
24/06/1997,CHF,1.438,0.40%,0.004,1.3,-4.4,33268,3964,8934,328,16913,11961,21205,21223,12063,12045,"(CONTRACTS OF 125,000 SWISS FRANCS)"
17/06/1997,CHF,1.4438,-0.19%,-0.0019,1.25,-4.39,32237,1731,11476,323,20739,8211,22793,20010,9444,12227,"(CONTRACTS OF 125,000 SWISS FRANCS)"
10/06/1997,CHF,1.441,-0.31%,-0.0031,1.38,-4.31,51562,1740,11686,1194,36085,25073,39019,37953,12543,13609,"(CONTRACTS OF 125,000 SWISS FRANCS)"
03/06/1997,CHF,1.4365,-1.16%,-0.0116,1,-4.64,45882,14180,2655,500,12311,29793,26991,32948,18891,12934,"(CONTRACTS OF 125,000 SWISS FRANCS)"
27/05/1997,CHF,1.42,-2.42%,-0.0239,1.25,-4.44,52533,18603,3285,1000,11884,35286,31487,39571,21046,12962,"(CONTRACTS OF 125,000 SWISS FRANCS)"
20/05/1997,CHF,1.3865,3.31%,0.0337,1.43,-4.1,50826,17905,3526,971,11588,34172,30464,38669,20362,12157,"(CONTRACTS OF 125,000 SWISS FRANCS)"
13/05/1997,CHF,1.434,1.92%,0.0193,1.68,-4.03,44657,14002,4053,796,11959,26087,26757,30936,17900,13721,"(CONTRACTS OF 125,000 SWISS FRANCS)"
06/05/1997,CHF,1.462,0.38%,0.0038,1.56,-4.12,47165,1394,13674,722,31792,15303,33908,29699,13257,17466,"(CONTRACTS OF 125,000 SWISS FRANCS)"
29/04/1997,CHF,1.4676,-0.31%,-0.0031,1.68,-4,47384,250,17173,722,35617,12758,36589,30653,10795,16731,"(CONTRACTS OF 125,000 SWISS FRANCS)"
22/04/1997,CHF,1.463,0.14%,0.0014,1.76,-3.92,47526,550,17129,677,34145,12233,35372,30039,12154,17487,"(CONTRACTS OF 125,000 SWISS FRANCS)"
15/04/1997,CHF,1.465,0.62%,0.0063,1.78,-3.92,45313,286,17077,730,34426,10318,35442,28125,9871,17188,"(CONTRACTS OF 125,000 SWISS FRANCS)"
08/04/1997,CHF,1.4742,-2.30%,-0.0228,1.78,-3.92,46392,274,16938,799,33496,11061,34569,28798,11823,17594,"(CONTRACTS OF 125,000 SWISS FRANCS)"
01/04/1997,CHF,1.441,1.64%,0.0165,1.81,-3.87,43347,746,15872,801,29707,11845,31254,28518,12093,14829,"(CONTRACTS OF 125,000 SWISS FRANCS)"
25/03/1997,CHF,1.465,-1.81%,-0.0179,1.8,-3.81,40567,200,14938,753,30063,10381,31016,26072,9551,14495,"(CONTRACTS OF 125,000 SWISS FRANCS)"
18/03/1997,CHF,1.439,2.14%,0.0217,1.68,-3.85,41033,903,15837,777,25955,8232,27635,24846,13398,16187,"(CONTRACTS OF 125,000 SWISS FRANCS)"
11/03/1997,CHF,1.4705,1.08%,0.0108,1.65,-3.79,59695,956,18034,765,48235,20459,49956,39258,9739,20437,"(CONTRACTS OF 125,000 SWISS FRANCS)"
04/03/1997,CHF,1.4865,-1.78%,-0.0176,1.62,-3.79,57904,850,19645,591,46161,14155,47602,34391,10302,23513,"(CONTRACTS OF 125,000 SWISS FRANCS)"
25/02/1997,CHF,1.4605,0.65%,0.0065,1.55,-3.76,56211,400,19691,597,45325,14794,46322,35082,9889,21129,"(CONTRACTS OF 125,000 SWISS FRANCS)"
18/02/1997,CHF,1.47,-2.25%,-0.0222,1.69,-3.65,55515,400,19269,260,44392,15271,45052,34800,10463,20715,"(CONTRACTS OF 125,000 SWISS FRANCS)"
11/02/1997,CHF,1.4377,-0.86%,-0.0085,1.59,-3.72,52976,795,18754,260,41697,13016,42752,32030,10224,20946,"(CONTRACTS OF 125,000 SWISS FRANCS)"
04/02/1997,CHF,1.4255,0.07%,0.0007,1.56,-3.84,51787,657,19019,233,42194,10707,43084,29959,8703,21828,"(CONTRACTS OF 125,000 SWISS FRANCS)"
28/01/1997,CHF,1.4265,-0.56%,-0.0056,1.72,-3.7,53727,241,18728,219,43443,11709,43903,30656,9824,23071,"(CONTRACTS OF 125,000 SWISS FRANCS)"
21/01/1997,CHF,1.4185,-3.28%,-0.0322,1.56,-3.87,51415,200,19664,260,40506,9176,40966,29100,10449,22315,"(CONTRACTS OF 125,000 SWISS FRANCS)"
14/01/1997,CHF,1.3735,-1.52%,-0.015,1.43,-3.88,55678,200,20290,1201,44176,10744,45577,32235,10101,23443,"(CONTRACTS OF 125,000 SWISS FRANCS)"
07/01/1997,CHF,1.353,-0.89%,-0.0089,1.62,-3.8,50060,700,17954,1256,39362,10236,41318,29446,8742,20614,"(CONTRACTS OF 125,000 SWISS FRANCS)"
31/12/1996,CHF,1.341,0.13%,0.0013,1.78,-3.65,45105,300,16332,2456,35867,7340,38623,26128,6482,18977,"(CONTRACTS OF 125,000 SWISS FRANCS)"
24/12/1996,CHF,1.3428,-1.32%,-0.0131,1.88,-3.58,47461,300,18214,2222,38757,8043,41279,28479,6182,18982,"(CONTRACTS OF 125,000 SWISS FRANCS)"
17/12/1996,CHF,1.3253,0.07%,0.0007,2,-3.48,44882,700,16264,1730,35872,8667,38302,26661,6580,18221,"(CONTRACTS OF 125,000 SWISS FRANCS)"
10/12/1996,CHF,1.3262,-0.51%,-0.0051,2.13,-3.24,73935,663,17485,1200,63643,32464,65506,51149,8429,22786,"(CONTRACTS OF 125,000 SWISS FRANCS)"
03/12/1996,CHF,1.3195,-2.30%,-0.0228,1.97,-3.59,61545,456,16116,884,48067,18294,49407,35294,12138,26251,"(CONTRACTS OF 125,000 SWISS FRANCS)"
26/11/1996,CHF,1.2898,-1.52%,-0.0151,1.95,-3.43,60096,500,17733,1116,48791,15787,50407,34636,9689,25460,"(CONTRACTS OF 125,000 SWISS FRANCS)"
19/11/1996,CHF,1.2705,-0.17%,-0.0017,1.83,-3.54,53953,8,15846,644,44873,14506,45525,30996,8428,22957,"(CONTRACTS OF 125,000 SWISS FRANCS)"
12/11/1996,CHF,1.2684,0.66%,0.0066,1.75,-3.65,52267,8,14688,593,42885,13958,43486,29239,8781,23028,"(CONTRACTS OF 125,000 SWISS FRANCS)"
05/11/1996,CHF,1.2768,-1.66%,-0.0164,1.95,-3.42,49394,2,15610,611,39677,11210,40290,27431,9104,21963,"(CONTRACTS OF 125,000 SWISS FRANCS)"
29/10/1996,CHF,1.256,-0.16%,-0.0016,1.75,-3.62,45897,220,13627,851,37559,11892,38630,26370,7267,19527,"(CONTRACTS OF 125,000 SWISS FRANCS)"
22/10/1996,CHF,1.254,1.10%,0.0111,1.5,-3.9,51411,295,16092,1486,41046,12720,42827,30298,8584,21113,"(CONTRACTS OF 125,000 SWISS FRANCS)"
15/10/1996,CHF,1.268,-1.08%,-0.0107,1.55,-3.8,48939,1113,15542,1333,39242,9946,41688,26821,7251,22118,"(CONTRACTS OF 125,000 SWISS FRANCS)"
08/10/1996,CHF,1.2545,0.13%,0.0013,1.44,-3.95,47903,1373,13995,1339,35772,10839,38484,26173,9419,21730,"(CONTRACTS OF 125,000 SWISS FRANCS)"
01/10/1996,CHF,1.2561,-2.51%,-0.0248,1.44,-4.06,41837,454,13484,1235,33327,7609,35016,22328,6821,19509,"(CONTRACTS OF 125,000 SWISS FRANCS)"
24/09/1996,CHF,1.2253,1.48%,0.0149,1.62,-3.75,38997,230,13003,1018,28306,7482,29554,21503,9443,17494,"(CONTRACTS OF 125,000 SWISS FRANCS)"
17/09/1996,CHF,1.2437,-0.87%,-0.0086,1.75,-3.75,35888,200,12374,1049,27184,5189,28433,18612,7455,17276,"(CONTRACTS OF 125,000 SWISS FRANCS)"
10/09/1996,CHF,1.233,-1.99%,-0.0197,1.85,-3.64,50231,1908,9043,897,34553,21590,37358,31530,12873,18701,"(CONTRACTS OF 125,000 SWISS FRANCS)"
03/09/1996,CHF,1.209,-1.35%,-0.0134,1.93,-3.57,40301,8439,1423,1650,13337,22286,23426,25359,16875,14942,"(CONTRACTS OF 125,000 SWISS FRANCS)"
27/08/1996,CHF,1.1929,1.14%,0.0114,2.15,-3.16,42079,10575,2299,1366,12389,23318,24330,26983,17749,15096,"(CONTRACTS OF 125,000 SWISS FRANCS)"
20/08/1996,CHF,1.2066,-0.62%,-0.0062,2.28,-3.09,39413,9258,1906,1377,12518,21788,23153,25071,16260,14342,"(CONTRACTS OF 125,000 SWISS FRANCS)"
13/08/1996,CHF,1.1992,0.66%,0.0066,2.25,-3.13,39211,8909,2056,1795,11161,22674,21865,26525,17346,12686,"(CONTRACTS OF 125,000 SWISS FRANCS)"
06/08/1996,CHF,1.2072,-0.42%,-0.0042,2.28,-3.12,40775,9557,1813,1780,12245,24509,23582,28102,17193,12673,"(CONTRACTS OF 125,000 SWISS FRANCS)"
30/07/1996,CHF,1.2022,0.87%,0.0087,2.37,-3.19,39471,8620,2668,1989,13111,22185,23720,26842,15751,12629,"(CONTRACTS OF 125,000 SWISS FRANCS)"
23/07/1996,CHF,1.2127,0.48%,0.0049,2.37,-3.06,37846,8516,2830,2020,13391,21434,23927,26284,13919,11562,"(CONTRACTS OF 125,000 SWISS FRANCS)"
16/07/1996,CHF,1.2186,3.57%,0.0363,2.56,-2.87,38421,5634,3680,2002,16863,16061,24499,21743,13922,16678,"(CONTRACTS OF 125,000 SWISS FRANCS)"
09/07/1996,CHF,1.2637,-1.06%,-0.0106,2.57,-3.02,38121,702,12876,979,28778,6846,30459,20701,7662,17420,"(CONTRACTS OF 125,000 SWISS FRANCS)"
02/07/1996,CHF,1.2504,0.75%,0.0076,2.38,-2.99,37132,108,13252,958,28669,5404,29735,19614,7397,17518,"(CONTRACTS OF 125,000 SWISS FRANCS)"
25/06/1996,CHF,1.2599,-1.12%,-0.0111,2.59,-2.84,37605,0,12876,857,28872,4287,29729,18020,7876,19585,"(CONTRACTS OF 125,000 SWISS FRANCS)"
18/06/1996,CHF,1.246,1.45%,0.0146,2.39,-3.01,35968,800,11859,822,25467,5551,27089,18232,8879,17736,"(CONTRACTS OF 125,000 SWISS FRANCS)"
11/06/1996,CHF,1.2643,-0.54%,-0.0054,2.41,-3.02,53717,432,15009,614,42428,14358,43474,29981,10243,23736,"(CONTRACTS OF 125,000 SWISS FRANCS)"
04/06/1996,CHF,1.2575,1.14%,0.0115,2.56,-2.81,45873,306,13959,502,34948,9472,35756,23933,10117,21940,"(CONTRACTS OF 125,000 SWISS FRANCS)"
28/05/1996,CHF,1.272,-0.29%,-0.0029,2.18,-3.16,48045,1482,17027,587,36984,7598,39053,25212,8992,22833,"(CONTRACTS OF 125,000 SWISS FRANCS)"
21/05/1996,CHF,1.2683,-1.46%,-0.0145,2,-3.43,48697,1387,16518,546,36709,7785,38642,24849,10055,23848,"(CONTRACTS OF 125,000 SWISS FRANCS)"
14/05/1996,CHF,1.25,-0.44%,-0.0044,1.75,-3.56,46693,1916,16520,663,35246,7061,37825,24244,8868,22449,"(CONTRACTS OF 125,000 SWISS FRANCS)"
07/05/1996,CHF,1.2445,-0.04%,-0.0004,1.68,-3.82,46306,1770,16853,562,34804,5930,37136,23345,9170,22961,"(CONTRACTS OF 125,000 SWISS FRANCS)"
30/04/1996,CHF,1.244,-0.85%,-0.0085,1.62,-3.75,45847,1591,16543,585,35383,5791,37559,22919,8288,22928,"(CONTRACTS OF 125,000 SWISS FRANCS)"
23/04/1996,CHF,1.2335,-0.41%,-0.0041,1.62,-3.69,43350,2319,15063,442,32887,5395,35648,20900,7702,22450,"(CONTRACTS OF 125,000 SWISS FRANCS)"
16/04/1996,CHF,1.2285,-1.45%,-0.0143,1.77,-3.54,43303,1477,14789,423,34343,4482,36243,19694,7060,23609,"(CONTRACTS OF 125,000 SWISS FRANCS)"
09/04/1996,CHF,1.211,-1.36%,-0.0135,1.69,-3.49,36186,1278,9305,657,26134,5685,28069,15647,8117,20539,"(CONTRACTS OF 125,000 SWISS FRANCS)"
02/04/1996,CHF,1.1948,-0.18%,-0.0018,1.5,-3.84,29759,1343,6832,687,19838,7155,21868,14674,7891,15085,"(CONTRACTS OF 125,000 SWISS FRANCS)"
26/03/1996,CHF,1.1926,-0.24%,-0.0024,1.72,-3.74,28394,763,7302,465,20605,5338,21833,13105,6561,15289,"(CONTRACTS OF 125,000 SWISS FRANCS)"
19/03/1996,CHF,1.1898,0.26%,0.0026,1.56,-3.74,27331,464,7241,463,19703,4789,20630,12493,6701,14838,"(CONTRACTS OF 125,000 SWISS FRANCS)"
12/03/1996,CHF,1.1929,0.48%,0.0048,1.62,-3.63,44072,1245,7880,657,32733,17575,34635,26112,9437,17960,"(CONTRACTS OF 125,000 SWISS FRANCS)"
05/03/1996,CHF,1.1986,-1.44%,-0.0143,1.56,-3.56,40718,265,7052,818,32133,13834,33216,21704,7502,19014,"(CONTRACTS OF 125,000 SWISS FRANCS)"
27/02/1996,CHF,1.1816,-0.28%,-0.0028,1.53,-3.61,38358,432,8938,844,29009,12245,30285,22027,8073,16331,"(CONTRACTS OF 125,000 SWISS FRANCS)"
20/02/1996,CHF,1.1783,2.03%,0.0205,1.62,-3.56,42777,1238,11405,1424,31975,9728,34637,22557,8140,20220,"(CONTRACTS OF 125,000 SWISS FRANCS)"
13/02/1996,CHF,1.2027,-0.39%,-0.0039,1.56,-3.56,44639,852,14587,1395,35344,6320,37591,22302,7048,22337,"(CONTRACTS OF 125,000 SWISS FRANCS)"
06/02/1996,CHF,1.198,1.52%,0.0153,1.7,-3.44,44430,611,14872,1300,35510,5988,37421,22160,7009,22270,"(CONTRACTS OF 125,000 SWISS FRANCS)"
30/01/1996,CHF,1.2165,-2.38%,-0.0235,1.68,-3.5,45089,364,14572,1254,37175,7072,38793,22898,6296,22191,"(CONTRACTS OF 125,000 SWISS FRANCS)"
23/01/1996,CHF,1.1882,-0.69%,-0.0069,1.68,-3.62,44242,422,14113,1111,36688,7885,38221,23109,6021,21133,"(CONTRACTS OF 125,000 SWISS FRANCS)"
16/01/1996,CHF,1.18,-1.59%,-0.0158,1.43,-3.9,42831,757,12264,1043,33165,8039,34965,21346,7866,21485,"(CONTRACTS OF 125,000 SWISS FRANCS)"
09/01/1996,CHF,1.1615,-0.26%,-0.0026,1.7,-3.71,40162,1806,12940,935,30595,7190,33336,21065,6826,19097,"(CONTRACTS OF 125,000 SWISS FRANCS)"
02/01/1996,CHF,1.1585,-0.56%,-0.0056,1.69,-3.74,36133,1922,11150,361,27293,7044,29576,18555,6557,17578,"(CONTRACTS OF 125,000 SWISS FRANCS)"
26/12/1995,CHF,1.152,0.35%,0.0035,1.68,-3.82,33670,561,11128,815,27038,6048,28414,17991,5256,15679,"(CONTRACTS OF 125,000 SWISS FRANCS)"
19/12/1995,CHF,1.156,1.53%,0.0155,1.68,-3.82,35059,638,11523,805,27879,5768,29322,18096,5737,16963,"(CONTRACTS OF 125,000 SWISS FRANCS)"
12/12/1995,CHF,1.174,-0.77%,-0.0077,2.03,-3.63,54754,812,12625,1590,44726,17621,47128,31836,7626,22918,"(CONTRACTS OF 125,000 SWISS FRANCS)"
05/12/1995,CHF,1.165,-0.73%,-0.0073,2.12,-3.53,46387,297,12156,1170,39203,12075,40670,25401,5717,20986,"(CONTRACTS OF 125,000 SWISS FRANCS)"
28/11/1995,CHF,1.1565,-1.71%,-0.0169,1.87,-3.82,38138,4437,2655,961,24159,16921,29557,20537,8581,17601,"(CONTRACTS OF 125,000 SWISS FRANCS)"
21/11/1995,CHF,1.1371,0.32%,0.0032,1.93,-3.91,38199,4374,1612,961,21374,20459,26709,23032,11490,15167,"(CONTRACTS OF 125,000 SWISS FRANCS)"
14/11/1995,CHF,1.1408,-0.20%,-0.002,1.93,-3.69,37373,4144,1832,1134,19528,19884,24806,22850,12567,14523,"(CONTRACTS OF 125,000 SWISS FRANCS)"
07/11/1995,CHF,1.1385,-0.22%,-0.0022,2.09,-3.61,36385,4849,2044,984,18429,19132,24262,22160,12123,14225,"(CONTRACTS OF 125,000 SWISS FRANCS)"
31/10/1995,CHF,1.136,0.00%,0,1.89,-3.92,36923,5129,1707,915,17264,19733,23308,22355,13615,14568,"(CONTRACTS OF 125,000 SWISS FRANCS)"
24/10/1995,CHF,1.136,0.92%,0.0092,2.08,-3.73,36765,5817,1727,696,16561,20332,23074,22755,13691,14010,"(CONTRACTS OF 125,000 SWISS FRANCS)"
17/10/1995,CHF,1.1465,0.09%,0.0009,2.14,-3.61,33947,5515,2525,704,16961,17325,23180,20554,10767,13393,"(CONTRACTS OF 125,000 SWISS FRANCS)"
10/10/1995,CHF,1.1475,1.03%,0.0104,2.06,-3.67,35256,5801,2536,1023,17080,18242,23904,21801,11352,13455,"(CONTRACTS OF 125,000 SWISS FRANCS)"
03/10/1995,CHF,1.1595,0.23%,0.0023,2.31,-3.47,32377,5518,2268,960,15441,15872,21919,19100,10458,13277,"(CONTRACTS OF 125,000 SWISS FRANCS)"
26/09/1995,CHF,1.1622,3.37%,0.0343,2.43,-3.27,30378,5473,1887,678,14815,15600,20966,18165,9412,12213,"(CONTRACTS OF 125,000 SWISS FRANCS)"
19/09/1995,CHF,1.2027,0.07%,0.0007,2.78,-2.88,30280,575,8623,528,23837,3982,24940,13133,5340,17147,"(CONTRACTS OF 125,000 SWISS FRANCS)"
12/09/1995,CHF,1.2035,-0.29%,-0.0029,2.85,-2.83,37482,412,8865,1255,26526,8559,28193,18679,9289,18803,"(CONTRACTS OF 125,000 SWISS FRANCS)"
05/09/1995,CHF,1.2,1.40%,0.0141,2.75,-2.87,32725,537,6501,382,23791,7288,24710,14171,8015,18554,"(CONTRACTS OF 125,000 SWISS FRANCS)"
29/08/1995,CHF,1.217,1.31%,0.0132,2.81,-2.94,32786,373,7230,252,25184,7348,25809,14830,6977,17956,"(CONTRACTS OF 125,000 SWISS FRANCS)"
22/08/1995,CHF,1.2332,0.05%,0.0005,2.88,-2.99,30931,333,7207,434,23348,6161,24115,13802,6816,17129,"(CONTRACTS OF 125,000 SWISS FRANCS)"
15/08/1995,CHF,1.2338,-5.77%,-0.0561,2.87,-2.94,30609,345,7118,1520,21457,6391,23322,15029,7287,15580,"(CONTRACTS OF 125,000 SWISS FRANCS)"
08/08/1995,CHF,1.1665,-2.57%,-0.0254,2.78,-2.94,27966,1433,4113,1496,16595,10145,19524,15754,8442,12212,"(CONTRACTS OF 125,000 SWISS FRANCS)"
01/08/1995,CHF,1.1373,1.88%,0.019,2.62,-3.13,28357,3691,3843,1565,12141,11984,17397,17392,10960,10965,"(CONTRACTS OF 125,000 SWISS FRANCS)"
25/07/1995,CHF,1.1591,0.11%,0.0011,2.68,-3.11,24511,623,4700,1538,14196,8024,16357,14262,8154,10249,"(CONTRACTS OF 125,000 SWISS FRANCS)"
18/07/1995,CHF,1.1604,0.86%,0.0087,2.7,-3.02,23963,843,5650,1552,14445,5058,16840,12260,7123,11703,"(CONTRACTS OF 125,000 SWISS FRANCS)"
11/07/1995,CHF,1.1705,-1.96%,-0.0194,2.87,-2.85,21877,595,4322,1327,12512,5392,14434,11041,7443,10836,"(CONTRACTS OF 125,000 SWISS FRANCS)"
03/07/1995,CHF,1.148,-0.17%,-0.0017,3.03,-2.82,19783,595,3395,1252,11068,5712,12915,10359,6868,9424,"(CONTRACTS OF 125,000 SWISS FRANCS)"
27/06/1995,CHF,1.146,0.59%,0.0059,3.18,-2.67,20581,1063,3208,1173,10333,5478,12569,9859,8012,10722,"(CONTRACTS OF 125,000 SWISS FRANCS)"
20/06/1995,CHF,1.1528,0.83%,0.0084,2.87,-3.02,20066,886,4202,758,10849,4475,12493,9435,7573,10631,"(CONTRACTS OF 125,000 SWISS FRANCS)"
13/06/1995,CHF,1.1625,0.09%,0.0009,3.09,-2.62,31048,993,4056,410,20856,13659,22259,18125,8789,12923,"(CONTRACTS OF 125,000 SWISS FRANCS)"
06/06/1995,CHF,1.1635,-1.35%,-0.0134,3,-2.81,28268,1230,4311,3346,14968,7982,19544,15639,8724,12629,"(CONTRACTS OF 125,000 SWISS FRANCS)"
30/05/1995,CHF,1.148,4.57%,0.0468,3.16,-2.77,28826,1713,4534,3531,14843,7852,20087,15917,8739,12909,"(CONTRACTS OF 125,000 SWISS FRANCS)"
23/05/1995,CHF,1.203,0.27%,0.0027,3.3,-2.7,32209,1440,7818,3410,17969,5601,22819,16829,9390,15380,"(CONTRACTS OF 125,000 SWISS FRANCS)"
16/05/1995,CHF,1.2063,-5.88%,-0.0571,3.48,-2.55,30369,1378,6483,3348,16238,7236,20964,17067,9405,13302,"(CONTRACTS OF 125,000 SWISS FRANCS)"
09/05/1995,CHF,1.1393,-0.42%,-0.0042,3.31,-2.5,30295,6747,860,2858,8472,15081,18077,18799,12218,11496,"(CONTRACTS OF 125,000 SWISS FRANCS)"
02/05/1995,CHF,1.1345,-0.53%,-0.0053,3.35,-2.71,30121,7110,1230,2433,9158,14716,18701,18379,11420,11742,"(CONTRACTS OF 125,000 SWISS FRANCS)"
25/04/1995,CHF,1.1285,-1.03%,-0.0102,3.25,-2.79,30557,7106,954,2186,8518,16125,17810,19265,12747,11292,"(CONTRACTS OF 125,000 SWISS FRANCS)"
18/04/1995,CHF,1.117,3.32%,0.0337,3.25,-2.81,30330,7982,1474,2130,7917,16663,18029,20267,12301,10063,"(CONTRACTS OF 125,000 SWISS FRANCS)"
11/04/1995,CHF,1.1553,-2.16%,-0.0213,3.4,-2.72,30048,7712,1298,2128,7502,16540,17342,19966,12706,10082,"(CONTRACTS OF 125,000 SWISS FRANCS)"
04/04/1995,CHF,1.1309,1.31%,0.0132,3.18,-3,30533,8412,1481,2215,5074,15244,15701,18940,14832,11593,"(CONTRACTS OF 125,000 SWISS FRANCS)"
28/03/1995,CHF,1.1459,2.29%,0.0232,3.56,-2.56,31523,8511,662,2101,4992,14391,15604,17154,15919,14369,"(CONTRACTS OF 125,000 SWISS FRANCS)"
21/03/1995,CHF,1.1728,0.37%,0.0037,3.62,-2.48,28744,9156,1069,2096,4334,14106,15586,17271,13158,11473,"(CONTRACTS OF 125,000 SWISS FRANCS)"
14/03/1995,CHF,1.1771,-3.44%,-0.0338,3.59,-2.53,48352,9843,1383,1561,3229,13804,14633,16748,33719,31604,"(CONTRACTS OF 125,000 SWISS FRANCS)"
07/03/1995,CHF,1.138,8.00%,0.0834,3.31,-2.81,53114,9649,3661,140,24533,28104,34322,31905,18792,21209,"(CONTRACTS OF 125,000 SWISS FRANCS)"
28/02/1995,CHF,1.237,0.45%,0.0045,3.72,-2.4,52017,9524,16271,849,24600,17045,34973,34165,17044,17852,"(CONTRACTS OF 125,000 SWISS FRANCS)"
21/02/1995,CHF,1.2426,2.44%,0.0247,3.69,-2.42,47637,8951,15255,948,20932,14759,30831,30962,16806,16675,"(CONTRACTS OF 125,000 SWISS FRANCS)"
14/02/1995,CHF,1.2737,2.08%,0.021,3.75,-2.37,41310,4936,13962,1138,22140,11197,28214,26297,13096,15013,"(CONTRACTS OF 125,000 SWISS FRANCS)"
07/02/1995,CHF,1.3007,-1.17%,-0.0116,3.66,-2.46,41778,4902,13675,971,24059,10971,29932,25617,11846,16161,"(CONTRACTS OF 125,000 SWISS FRANCS)"
31/01/1995,CHF,1.2857,-1.20%,-0.0119,3.75,-2.37,39957,7250,11540,1056,16847,12097,25153,24693,14804,15264,"(CONTRACTS OF 125,000 SWISS FRANCS)"
24/01/1995,CHF,1.2705,1.17%,0.0117,3.88,-2.33,40894,9294,10983,1173,15319,13962,25786,26118,15108,14776,"(CONTRACTS OF 125,000 SWISS FRANCS)"
17/01/1995,CHF,1.2855,-0.27%,-0.0027,3.97,-2.15,39313,8280,11188,650,15731,12728,24661,24566,14652,14747,"(CONTRACTS OF 125,000 SWISS FRANCS)"
10/01/1995,CHF,1.282,2.44%,0.0247,3.81,-2.37,39893,8243,11662,650,18121,10440,27014,22752,12879,17141,"(CONTRACTS OF 125,000 SWISS FRANCS)"
03/01/1995,CHF,1.314,1.18%,0.0119,4.14,-2.17,35389,2474,12811,1502,23143,6001,27119,20314,8270,15075,"(CONTRACTS OF 125,000 SWISS FRANCS)"
27/12/1994,CHF,1.3297,-0.15%,-0.0015,4.1,-2.08,38448,2347,18418,334,29434,1932,32115,20684,6333,17764,"(CONTRACTS OF 125,000 SWISS FRANCS)"
20/12/1994,CHF,1.3277,0.12%,0.0012,4.12,-1.94,64552,2242,17657,391,27299,2149,29932,20197,34620,44355,"(CONTRACTS OF 125,000 SWISS FRANCS)"
13/12/1994,CHF,1.3293,-0.17%,-0.0017,4,-2.31,66463,2413,25701,1407,51029,17644,54849,44752,11614,21711,"(CONTRACTS OF 125,000 SWISS FRANCS)"
06/12/1994,CHF,1.327,0.15%,0.0015,3.88,-2.3,63355,1981,26451,1444,47521,12672,50946,40567,12409,22788,"(CONTRACTS OF 125,000 SWISS FRANCS)"
29/11/1994,CHF,1.329,-0.76%,-0.0076,3.75,-2.18,61211,2756,25746,2116,44914,11399,49786,39261,11425,21950,"(CONTRACTS OF 125,000 SWISS FRANCS)"
22/11/1994,CHF,1.319,-0.73%,-0.0072,3.87,-1.81,60065,2997,25151,2134,42309,11931,47440,39216,12625,20849,"(CONTRACTS OF 125,000 SWISS FRANCS)"
15/11/1994,CHF,1.3095,-3.83%,-0.0376,3.81,-1.94,51985,3565,19097,1629,34878,13522,40072,34248,11913,17737,"(CONTRACTS OF 125,000 SWISS FRANCS)"
08/11/1994,CHF,1.2612,-1.24%,-0.0124,3.81,-1.94,44280,12507,8698,1515,13585,17111,27607,27324,16673,16956,"(CONTRACTS OF 125,000 SWISS FRANCS)"
01/11/1994,CHF,1.2457,0.37%,0.0037,3.95,-1.6,43625,14811,3420,1474,9862,19751,26147,24645,17478,18980,"(CONTRACTS OF 125,000 SWISS FRANCS)"
25/10/1994,CHF,1.2503,-0.30%,-0.003,3.81,-1.75,42328,16267,1972,957,5365,21398,22589,24327,19739,18001,"(CONTRACTS OF 125,000 SWISS FRANCS)"
18/10/1994,CHF,1.2465,3.27%,0.0333,3.93,-1.5,43199,17105,1255,532,5478,22603,23115,24390,20084,18809,"(CONTRACTS OF 125,000 SWISS FRANCS)"
11/10/1994,CHF,1.2887,-0.33%,-0.0033,4.01,-1.49,35412,11202,2122,524,7434,16225,19160,18871,16252,16541,"(CONTRACTS OF 125,000 SWISS FRANCS)"
04/10/1994,CHF,1.2844,-0.62%,-0.0062,4.06,-1.31,34270,11462,2249,364,4941,15816,16767,18429,17503,15841,"(CONTRACTS OF 125,000 SWISS FRANCS)"
27/09/1994,CHF,1.2765,0.62%,0.0062,3.85,-1.27,36750,13605,1455,293,3272,20482,17170,22230,19580,14520,"(CONTRACTS OF 125,000 SWISS FRANCS)"
20/09/1994,CHF,1.2845,0.02%,0.0002,4.03,-0.9,50723,14139,853,263,1915,19804,16317,20920,34406,29803,"(CONTRACTS OF 125,000 SWISS FRANCS)"
13/09/1994,CHF,1.2848,0.75%,0.0075,3.93,-0.97,54183,15309,1679,851,15365,31357,31525,33887,22658,20296,"(CONTRACTS OF 125,000 SWISS FRANCS)"
06/09/1994,CHF,1.2945,2.60%,0.0263,4.18,-0.68,45660,14985,588,1745,9742,23914,26472,26247,19188,19413,"(CONTRACTS OF 125,000 SWISS FRANCS)"
30/08/1994,CHF,1.329,-2.98%,-0.0294,4.18,-0.69,42930,12030,2228,2447,12342,20317,26819,24992,16111,17938,"(CONTRACTS OF 125,000 SWISS FRANCS)"
23/08/1994,CHF,1.2905,1.64%,0.0165,4.17,-0.66,46475,20953,588,495,4991,27074,26439,28157,20036,18318,"(CONTRACTS OF 125,000 SWISS FRANCS)"
16/08/1994,CHF,1.312,1.58%,0.016,4.23,-0.7,47245,19746,707,102,6686,26174,26534,26983,20711,20262,"(CONTRACTS OF 125,000 SWISS FRANCS)"
09/08/1994,CHF,1.3331,0.24%,0.0024,4.12,-0.63,41060,15910,805,4,9137,23304,25051,24113,16009,16947,"(CONTRACTS OF 125,000 SWISS FRANCS)"
02/08/1994,CHF,1.3363,0.62%,0.0063,4.23,-0.33,40035,13238,1284,4,10375,21155,23617,22443,16418,17592,"(CONTRACTS OF 125,000 SWISS FRANCS)"
26/07/1994,CHF,1.3447,-1.33%,-0.0133,4.18,-0.49,38445,12911,1427,4,9367,20663,22282,22094,16163,16351,"(CONTRACTS OF 125,000 SWISS FRANCS)"
19/07/1994,CHF,1.327,-2.80%,-0.0277,4.1,-0.33,44560,18295,3401,0,4929,22942,23224,26343,21336,18217,"(CONTRACTS OF 125,000 SWISS FRANCS)"
12/07/1994,CHF,1.2908,2.65%,0.0269,4.07,-0.61,48176,21423,921,0,2875,28623,24298,29544,23878,18632,"(CONTRACTS OF 125,000 SWISS FRANCS)"
05/07/1994,CHF,1.326,0.05%,0.0005,4.25,-0.54,49622,23217,1583,320,3331,30690,26868,32593,22754,17029,"(CONTRACTS OF 125,000 SWISS FRANCS)"
28/06/1994,CHF,1.3267,1.21%,0.0122,4.22,-0.34,51837,23916,3067,314,4509,31074,28739,34455,23098,17382,"(CONTRACTS OF 125,000 SWISS FRANCS)"
21/06/1994,CHF,1.343,3.10%,0.0315,4.29,-0.21,49148,23385,2311,200,2512,31271,26097,33782,23051,15366,"(CONTRACTS OF 125,000 SWISS FRANCS)"
14/06/1994,CHF,1.386,1.86%,0.0187,4.35,0.04,55025,18297,2839,202,1601,23268,20100,26309,34925,28716,"(CONTRACTS OF 125,000 SWISS FRANCS)"
07/06/1994,CHF,1.4122,-0.76%,-0.0076,4.18,-0.23,47643,10324,4351,1929,20575,25298,32828,31578,14815,16065,"(CONTRACTS OF 125,000 SWISS FRANCS)"
31/05/1994,CHF,1.4015,0.88%,0.0089,4.1,-0.4,47435,13175,4697,2102,15219,26134,30496,32933,16939,14502,"(CONTRACTS OF 125,000 SWISS FRANCS)"
24/05/1994,CHF,1.414,0.58%,0.0058,4.07,-0.43,44280,12616,4764,1961,14931,23929,29508,30654,14772,13626,"(CONTRACTS OF 125,000 SWISS FRANCS)"
17/05/1994,CHF,1.4222,0.71%,0.0071,3.93,-0.69,39475,12624,4082,250,12390,21932,25264,26264,14211,13211,"(CONTRACTS OF 125,000 SWISS FRANCS)"
10/05/1994,CHF,1.4324,-2.62%,-0.0259,3.87,-0.91,38163,11082,4842,248,12815,19181,24145,24271,14018,13892,"(CONTRACTS OF 125,000 SWISS FRANCS)"
03/05/1994,CHF,1.3958,2.43%,0.0246,3.93,-0.36,42704,16839,4522,53,8531,25519,25423,30094,17281,12610,"(CONTRACTS OF 125,000 SWISS FRANCS)"
26/04/1994,CHF,1.4306,0.85%,0.0086,3.9,-0.22,39486,8897,9291,291,19476,15701,28664,25283,10822,14203,"(CONTRACTS OF 125,000 SWISS FRANCS)"
19/04/1994,CHF,1.4429,0.15%,0.0015,3.92,-0.14,40579,6039,11619,358,24166,13151,30563,25128,10016,15451,"(CONTRACTS OF 125,000 SWISS FRANCS)"
12/04/1994,CHF,1.445,0.20%,0.002,3.93,0.05,34996,7104,6733,50,16606,14895,23760,21678,11236,13318,"(CONTRACTS OF 125,000 SWISS FRANCS)"
05/04/1994,CHF,1.4479,-1.79%,-0.0177,3.93,0,34614,9651,8268,94,10238,12187,19983,20549,14631,14065,"(CONTRACTS OF 125,000 SWISS FRANCS)"
29/03/1994,CHF,1.4225,0.35%,0.0035,3.87,0.14,36078,12703,6838,25,5713,15644,18441,22507,17637,13571,"(CONTRACTS OF 125,000 SWISS FRANCS)"
22/03/1994,CHF,1.4275,1.04%,0.0105,3.87,0.19,33164,11378,6009,265,4024,15042,15667,21316,17497,11848,"(CONTRACTS OF 125,000 SWISS FRANCS)"
15/03/1994,CHF,1.4425,-0.22%,-0.0022,3.93,0.18,53323,9927,5449,7,3898,16047,13832,21503,39491,31820,"(CONTRACTS OF 125,000 SWISS FRANCS)"
08/03/1994,CHF,1.4393,-0.21%,-0.0021,3.81,0,53479,10035,4700,0,22559,32705,32594,37405,20885,16074,"(CONTRACTS OF 125,000 SWISS FRANCS)"
01/03/1994,CHF,1.4363,0.84%,0.0085,4,0.38,52460,12666,7257,844,19286,27115,32796,35216,19664,17244,"(CONTRACTS OF 125,000 SWISS FRANCS)"
22/02/1994,CHF,1.4485,0.45%,0.0045,4,0.5,42850,8273,4672,229,21325,23222,29827,28123,13023,14727,"(CONTRACTS OF 125,000 SWISS FRANCS)"
15/02/1994,CHF,1.455,1.75%,0.0176,4.13,0.76,41673,5969,4754,0,22510,20943,28479,25697,13194,15976,"(CONTRACTS OF 125,000 SWISS FRANCS)"
08/02/1994,CHF,1.4809,-2.27%,-0.0225,4,0.57,51197,13932,9287,12,21724,22582,35668,31881,15529,19316,"(CONTRACTS OF 125,000 SWISS FRANCS)"
01/02/1994,CHF,1.448,1.24%,0.0125,3.96,0.78,42329,7529,7102,0,17989,20395,25518,27497,16811,14832,"(CONTRACTS OF 125,000 SWISS FRANCS)"
25/01/1994,CHF,1.4662,-0.36%,-0.0036,3.93,0.81,39015,2709,8450,0,22691,15627,25400,24077,13615,14938,"(CONTRACTS OF 125,000 SWISS FRANCS)"
18/01/1994,CHF,1.461,1.12%,0.0112,3.94,0.82,37906,5351,7281,0,17954,15159,23305,22440,14601,15466,"(CONTRACTS OF 125,000 SWISS FRANCS)"
11/01/1994,CHF,1.4775,0.32%,0.0032,3.87,0.75,47632,19198,9604,11,13737,20937,32946,30552,14686,17080,"(CONTRACTS OF 125,000 SWISS FRANCS)"
04/01/1994,CHF,1.4822,-3.01%,-0.0296,3.87,0.69,45960,18824,9384,7,12360,22017,31191,31408,14769,14552,"(CONTRACTS OF 125,000 SWISS FRANCS)"
28/12/1993,CHF,1.4389,0.63%,0.0063,4.07,0.95,51615,21824,7636,601,7753,30832,30178,39069,21437,12546,"(CONTRACTS OF 125,000 SWISS FRANCS)"
21/12/1993,CHF,1.448,1.11%,0.0112,3.93,0.75,36597,9111,8296,1,10007,16019,19119,24316,17478,12281,"(CONTRACTS OF 125,000 SWISS FRANCS)"
14/12/1993,CHF,1.4643,-0.38%,-0.0038,4.06,0.88,57749,4511,7851,543,33413,36486,38467,44880,19282,12869,"(CONTRACTS OF 125,000 SWISS FRANCS)"
07/12/1993,CHF,1.4588,2.55%,0.0258,4.13,0.83,55905,3955,7866,719,36857,28542,41531,37127,14374,18778,"(CONTRACTS OF 125,000 SWISS FRANCS)"
30/11/1993,CHF,1.497,-0.42%,-0.0042,4.4,1.02,60306,2631,21085,476,45480,12891,48587,34452,11719,25854,"(CONTRACTS OF 125,000 SWISS FRANCS)"
23/11/1993,CHF,1.4908,0.78%,0.0078,4.37,1.02,62440,3720,26092,309,48430,11699,52459,38100,9981,24340,"(CONTRACTS OF 125,000 SWISS FRANCS)"
16/11/1993,CHF,1.5025,-0.70%,-0.007,4.45,1.14,63853,2170,28623,5,52018,9298,54193,37926,9660,25927,"(CONTRACTS OF 125,000 SWISS FRANCS)"
09/11/1993,CHF,1.492,1.09%,0.011,4.5,1.19,53068,2403,15737,337,40794,11610,43534,27684,9534,25384,"(CONTRACTS OF 125,000 SWISS FRANCS)"
02/11/1993,CHF,1.5085,-2.15%,-0.0212,4.62,1.19,50833,2461,15629,328,37555,10994,40344,26951,10489,23882,"(CONTRACTS OF 125,000 SWISS FRANCS)"
26/10/1993,CHF,1.4768,-1.99%,-0.0197,4.4,1.15,38619,3342,4550,328,23827,16697,27497,21575,11122,17044,"(CONTRACTS OF 125,000 SWISS FRANCS)"
19/10/1993,CHF,1.448,-3.50%,-0.0344,4.45,1.2,50200,18596,4389,755,13927,29097,33278,34241,16922,15959,"(CONTRACTS OF 125,000 SWISS FRANCS)"
12/10/1993,CHF,1.399,1.65%,0.0167,4.47,1.22,62395,32713,3152,643,3939,48666,37295,52461,25100,9934,"(CONTRACTS OF 125,000 SWISS FRANCS)"
05/10/1993,CHF,1.4225,-0.85%,-0.0085,4.37,1.12,52744,27383,2612,370,3832,38576,31585,41558,21159,11186,"(CONTRACTS OF 125,000 SWISS FRANCS)"
28/09/1993,CHF,1.4105,0.81%,0.0081,4.5,1.44,53515,27160,2795,0,4168,40939,31328,43734,22187,9781,"(CONTRACTS OF 125,000 SWISS FRANCS)"
21/09/1993,CHF,1.422,-1.52%,-0.0151,4.5,1.44,54095,26831,3572,77,4003,40203,30911,43852,23184,10243,"(CONTRACTS OF 125,000 SWISS FRANCS)"
14/09/1993,CHF,1.4007,1.22%,0.0123,4.62,1.52,77997,27632,5186,21,24419,61405,52072,66612,25925,11385,"(CONTRACTS OF 125,000 SWISS FRANCS)"
07/09/1993,CHF,1.418,4.09%,0.0418,4.68,1.62,67712,17389,3817,819,24185,50098,42393,54734,25319,12978,"(CONTRACTS OF 125,000 SWISS FRANCS)"
31/08/1993,CHF,1.4785,-0.31%,-0.003,4.65,1.53,45524,7811,4887,1404,19751,25672,28966,31963,16558,13561,"(CONTRACTS OF 125,000 SWISS FRANCS)"
24/08/1993,CHF,1.474,1.90%,0.0192,4.62,1.5,43481,5159,5075,1143,22009,26104,28311,32322,15170,11159,"(CONTRACTS OF 125,000 SWISS FRANCS)"
17/08/1993,CHF,1.5025,1.49%,0.015,4.68,1.5,45718,1328,10671,1475,29287,16044,32090,28190,13628,17528,"(CONTRACTS OF 125,000 SWISS FRANCS)"
10/08/1993,CHF,1.5252,-1.58%,-0.0157,4.53,1.47,42524,884,10269,888,30313,12046,32085,23203,10439,19321,"(CONTRACTS OF 125,000 SWISS FRANCS)"
03/08/1993,CHF,1.5015,1.25%,0.0126,4.56,1.38,42625,1611,8609,792,27967,15430,30370,24831,12255,17794,"(CONTRACTS OF 125,000 SWISS FRANCS)"
27/07/1993,CHF,1.5205,-1.64%,-0.0162,4.53,1.35,42385,822,11517,790,32646,9696,34258,22003,8127,20382,"(CONTRACTS OF 125,000 SWISS FRANCS)"
20/07/1993,CHF,1.496,1.48%,0.0149,4.43,1.31,39824,850,9189,816,27966,10230,29632,20235,10192,19589,"(CONTRACTS OF 125,000 SWISS FRANCS)"
13/07/1993,CHF,1.5185,-0.43%,-0.0043,4.53,1.35,42581,725,14038,487,33511,5483,34723,20008,7858,22573,"(CONTRACTS OF 125,000 SWISS FRANCS)"
06/07/1993,CHF,1.512,-1.01%,-0.01,4.69,1.51,36466,2546,10678,665,25890,5829,29101,17172,7365,19294,"(CONTRACTS OF 125,000 SWISS FRANCS)"
29/06/1993,CHF,1.4969,0.92%,0.0092,4.88,1.7,34494,1890,10570,852,23633,5216,26375,16638,8119,17856,"(CONTRACTS OF 125,000 SWISS FRANCS)"
22/06/1993,CHF,1.5108,-2.71%,-0.0267,5,1.82,36595,3146,10974,255,25324,5785,28725,17014,7870,19581,"(CONTRACTS OF 125,000 SWISS FRANCS)"
15/06/1993,CHF,1.471,-0.67%,-0.0067,4.97,1.79,48267,3907,5002,10,32161,28493,36078,33505,12189,14762,"(CONTRACTS OF 125,000 SWISS FRANCS)"
08/06/1993,CHF,1.4612,-3.27%,-0.0321,5.03,2.03,51248,3595,2763,1128,28164,30782,32887,34673,18361,16575,"(CONTRACTS OF 125,000 SWISS FRANCS)"
01/06/1993,CHF,1.415,2.92%,0.0296,5.03,2.03,51931,6938,2848,1611,22275,33753,30824,38212,21107,13719,"(CONTRACTS OF 125,000 SWISS FRANCS)"
25/05/1993,CHF,1.4575,1.45%,0.0146,4.87,1.69,46509,4788,2387,1193,24175,29622,30156,33202,16353,13307,"(CONTRACTS OF 125,000 SWISS FRANCS)"
18/05/1993,CHF,1.479,-1.36%,-0.0135,4.93,1.93,46199,3182,2823,1184,25828,28360,30194,32367,16005,13832,"(CONTRACTS OF 125,000 SWISS FRANCS)"
11/05/1993,CHF,1.4592,-2.83%,-0.0279,4.94,1.88,45076,7113,2237,434,20527,31177,28074,33848,17002,11228,"(CONTRACTS OF 125,000 SWISS FRANCS)"
04/05/1993,CHF,1.419,0.70%,0.007,4.94,1.82,49940,11090,2060,279,16519,38570,27888,40909,22052,9031,"(CONTRACTS OF 125,000 SWISS FRANCS)"
27/04/1993,CHF,1.429,2.04%,0.0206,4.9,1.84,47873,10845,6008,243,17230,31437,28318,37688,19555,10185,"(CONTRACTS OF 125,000 SWISS FRANCS)"
20/04/1993,CHF,1.4588,-0.92%,-0.0092,4.93,1.81,44043,7382,5750,252,16464,29206,24098,35208,19945,8835,"(CONTRACTS OF 125,000 SWISS FRANCS)"
13/04/1993,CHF,1.4455,2.66%,0.027,4.93,1.75,43856,7744,4721,230,15157,29391,23131,34342,20725,9514,"(CONTRACTS OF 125,000 SWISS FRANCS)"
06/04/1993,CHF,1.485,0.62%,0.0062,4.87,1.75,38232,3056,8083,226,17722,16468,21004,24777,17228,13455,"(CONTRACTS OF 125,000 SWISS FRANCS)"
30/03/1993,CHF,1.4943,1.06%,0.0107,5,1.94,42624,2652,14130,226,22981,12489,25859,26845,16765,15779,"(CONTRACTS OF 125,000 SWISS FRANCS)"
23/03/1993,CHF,1.5103,0.96%,0.0097,4.87,1.69,43556,1914,14678,220,26810,12750,28944,27648,14612,15908,"(CONTRACTS OF 125,000 SWISS FRANCS)"
16/03/1993,CHF,1.525,0.95%,0.0096,5,1.88,54804,3226,10612,220,35833,27346,39279,38178,15525,16626,"(CONTRACTS OF 125,000 SWISS FRANCS)"
09/03/1993,CHF,1.5397,-1.20%,-0.0119,5.06,1.94,57029,2553,15532,1677,43610,19521,47840,36730,9189,20299,"(CONTRACTS OF 125,000 SWISS FRANCS)"
02/03/1993,CHF,1.5215,-1.60%,-0.0159,5.19,2.13,49032,2136,16567,1127,35572,14837,38835,32531,10197,16501,"(CONTRACTS OF 125,000 SWISS FRANCS)"
23/02/1993,CHF,1.4975,0.40%,0.004,5.37,2.31,47688,4393,14904,1134,30769,16536,36296,32574,11392,15114,"(CONTRACTS OF 125,000 SWISS FRANCS)"
16/02/1993,CHF,1.5035,1.80%,0.0181,5.56,2.44,48845,2262,15972,660,34891,12715,37813,29347,11032,19498,"(CONTRACTS OF 125,000 SWISS FRANCS)"
09/02/1993,CHF,1.531,-0.62%,-0.0062,5.28,2.16,48683,1879,15013,717,36353,11134,38949,26864,9734,21819,"(CONTRACTS OF 125,000 SWISS FRANCS)"
02/02/1993,CHF,1.5215,-4.82%,-0.0471,5.31,2.19,53145,2374,19101,9,41773,10406,44156,29516,8989,23629,"(CONTRACTS OF 125,000 SWISS FRANCS)"
26/01/1993,CHF,1.4515,1.43%,0.0144,5.38,2.32,45076,1757,14470,4,33938,11494,35699,25968,9377,19108,"(CONTRACTS OF 125,000 SWISS FRANCS)"
19/01/1993,CHF,1.4725,1.73%,0.0174,5.59,2.44,53749,2912,21422,16,42780,9083,45708,30521,8041,23228,"(CONTRACTS OF 125,000 SWISS FRANCS)"
12/01/1993,CHF,1.4984,-1.81%,-0.018,5.43,2.18,58287,3260,25864,43,46449,8806,49752,34713,8535,23574,"(CONTRACTS OF 125,000 SWISS FRANCS)"
05/01/1993,CHF,1.4717,-0.54%,-0.0054,5.68,2.43,51762,4563,21693,0,39974,9119,44537,30812,7225,20950,"(CONTRACTS OF 125,000 SWISS FRANCS)"
29/12/1992,CHF,1.4638,-1.58%,-0.0157,5.81,2.31,48548,3978,20627,0,38442,6979,42420,27606,6128,20942,"(CONTRACTS OF 125,000 SWISS FRANCS)"
22/12/1992,CHF,1.441,-2.23%,-0.0221,6.18,2.81,36979,3410,14726,205,27059,6262,30674,21193,6305,15786,"(CONTRACTS OF 125,000 SWISS FRANCS)"
15/12/1992,CHF,1.4095,-1.04%,-0.0103,6.12,2.25,50400,2238,12914,222,38224,22715,40684,35851,9716,14549,"(CONTRACTS OF 125,000 SWISS FRANCS)"
08/12/1992,CHF,1.395,0.53%,0.0054,6.31,2.69,49058,853,12347,443,37840,18381,39136,31171,9922,17887,"(CONTRACTS OF 125,000 SWISS FRANCS)"
01/12/1992,CHF,1.4025,1.89%,0.0191,6.5,2.69,46638,2744,14208,0,34811,13407,37555,27615,9083,19023,"(CONTRACTS OF 125,000 SWISS FRANCS)"
24/11/1992,CHF,1.4295,1.21%,0.0122,6.4,2.72,48957,3170,14523,228,37321,12529,40719,27280,8238,21677,"(CONTRACTS OF 125,000 SWISS FRANCS)"
17/11/1992,CHF,1.447,-0.87%,-0.0087,6.93,3.18,46606,2016,13032,0,34810,11473,36826,24505,9780,22101,"(CONTRACTS OF 125,000 SWISS FRANCS)"
10/11/1992,CHF,1.4345,-2.60%,-0.0256,6.43,3,44031,2270,11486,196,32943,11954,35409,23636,8622,20395,"(CONTRACTS OF 125,000 SWISS FRANCS)"
03/11/1992,CHF,1.3982,-2.81%,-0.0277,6.27,2.77,38934,1767,11015,432,28823,8503,31022,19950,7912,18984,"(CONTRACTS OF 125,000 SWISS FRANCS)"
27/10/1992,CHF,1.36,-0.33%,-0.0033,6.06,2.75,36367,902,10150,273,27456,8035,28631,18458,7736,17909,"(CONTRACTS OF 125,000 SWISS FRANCS)"
20/10/1992,CHF,1.3555,-3.91%,-0.0384,6.13,2.7,39292,2377,15033,378,29688,6527,32443,21938,6849,17354,"(CONTRACTS OF 125,000 SWISS FRANCS)"
13/10/1992,CHF,1.3045,-4.61%,-0.0451,6.38,3.07,32660,6725,13029,366,15078,7205,22169,20600,10491,12060,"(CONTRACTS OF 125,000 SWISS FRANCS)"
06/10/1992,CHF,1.247,-0.89%,-0.0089,6.31,3.25,32311,7287,7359,667,11047,12889,19001,20915,13310,11396,"(CONTRACTS OF 125,000 SWISS FRANCS)"
30/09/1992,CHF,1.236,5.36%,0.0536,6.81,3.81,29557,6530,6490,0,10946,12047,17476,18537,12081,11020,"(CONTRACTS OF 125,000 SWISS FRANCS)"
30/12/2008,GBP,1.4435,2.70%,-0.0273,2.57,1.01,76340,9317,45160,73,42543,12562,51933,57795,24407,18545,"(CONTRACTS OF GBP 62,500)"
22/12/2008,GBP,1.4835,4.92%,-0.0505,2.62,0.88,70151,8817,40447,85,37806,12466,46708,52998,23443,17153,"(CONTRACTS OF GBP 62,500)"
16/12/2008,GBP,1.5603,-5.88%,0.0572,2.98,1.16,64421,7200,37600,213,32860,9608,40273,47421,24148,17000,"(CONTRACTS OF GBP 62,500)"
09/12/2008,GBP,1.4736,1.13%,-0.0114,2.77,0.72,122570,5892,43318,1027,103821,48667,110740,93012,11830,29558,"(CONTRACTS OF GBP 62,500)"
02/12/2008,GBP,1.4905,3.60%,-0.0367,3.01,-0.32,115876,6199,45424,641,95755,44797,102595,90862,13281,25014,"(CONTRACTS OF GBP 62,500)"
25/11/2008,GBP,1.5462,-3.31%,0.0325,3.3,-0.14,117162,7289,47533,332,96240,44391,103861,92256,13301,24906,"(CONTRACTS OF GBP 62,500)"
18/11/2008,GBP,1.4967,2.70%,-0.0274,3.77,1.5,112652,5160,47591,196,95606,39836,100962,87623,11690,25029,"(CONTRACTS OF GBP 62,500)"
11/11/2008,GBP,1.5382,3.96%,-0.0404,4.18,1.76,110560,5967,45805,426,93539,40942,99932,87173,10628,23387,"(CONTRACTS OF GBP 62,500)"
04/11/2008,GBP,1.6016,-0.57%,0.0057,5.4,3.08,115676,12548,47813,318,91386,45694,104252,93825,11424,21851,"(CONTRACTS OF GBP 62,500)"
28/10/2008,GBP,1.5925,4.54%,-0.0465,5.69,2.12,130716,18591,51681,362,87906,43237,106859,95280,23857,35436,"(CONTRACTS OF GBP 62,500)"
21/10/2008,GBP,1.6683,4.16%,-0.0425,5.66,2.16,116248,16095,52796,171,86050,35400,102316,88367,13932,27881,"(CONTRACTS OF GBP 62,500)"
14/10/2008,GBP,1.7408,0.37%,-0.0037,5.98,1.5,101182,15804,47277,106,76380,31712,92290,79095,8892,22087,"(CONTRACTS OF GBP 62,500)"
07/10/2008,GBP,1.7473,1.99%,-0.0201,5.39,0.69,101018,20112,55336,225,73052,21859,93389,77420,7629,23598,"(CONTRACTS OF GBP 62,500)"
30/09/2008,GBP,1.7828,3.68%,-0.0375,5.45,1.12,101945,19488,52524,729,71148,24342,91365,77595,10580,24350,"(CONTRACTS OF GBP 62,500)"
23/09/2008,GBP,1.8509,-3.66%,0.0359,5.75,1.67,98762,12008,59779,230,75772,13117,88010,73126,10752,25636,"(CONTRACTS OF GBP 62,500)"
16/09/2008,GBP,1.7856,-1.37%,0.0136,5.77,3.05,105913,18353,67712,35,74572,12287,92960,80034,12953,25879,"(CONTRACTS OF GBP 62,500)"
09/09/2008,GBP,1.7615,1.15%,-0.0116,5.65,2.8,127527,16511,64031,3973,85124,25230,105608,93234,21919,34293,"(CONTRACTS OF GBP 62,500)"
02/09/2008,GBP,1.782,3.12%,-0.0317,5.65,2.79,120499,12504,59789,1812,86685,25622,101001,87223,19498,33276,"(CONTRACTS OF GBP 62,500)"
26/08/2008,GBP,1.8394,1.51%,-0.0152,5.67,2.92,115174,16211,61320,1614,83264,20109,101089,83043,14085,32131,"(CONTRACTS OF GBP 62,500)"
19/08/2008,GBP,1.8676,1.53%,-0.0154,5.67,2.76,109921,14836,58564,940,77262,18099,93038,77603,16883,32318,"(CONTRACTS OF GBP 62,500)"
12/08/2008,GBP,1.8966,2.94%,-0.0298,5.7,2.85,99819,18886,51832,558,65051,18559,84495,70949,15324,28870,"(CONTRACTS OF GBP 62,500)"
05/08/2008,GBP,1.954,1.28%,-0.0129,5.74,2.91,93022,21707,47582,796,55110,19669,77613,68047,15409,24975,"(CONTRACTS OF GBP 62,500)"
29/07/2008,GBP,1.9794,0.56%,-0.0056,5.7,2.99,102737,43269,41809,573,39755,36064,83597,78446,19140,24291,"(CONTRACTS OF GBP 62,500)"
22/07/2008,GBP,1.9906,0.75%,-0.0075,5.68,2.8,107323,48513,45191,478,37520,36779,86511,82448,20812,24875,"(CONTRACTS OF GBP 62,500)"
15/07/2008,GBP,2.0056,-1.84%,0.0183,5.7,2.83,108703,50345,43922,453,37035,41007,87833,85382,20870,23321,"(CONTRACTS OF GBP 62,500)"
08/07/2008,GBP,1.9693,1.27%,-0.0128,5.76,2.76,83736,31256,39554,324,32537,18549,64117,58427,19619,25309,"(CONTRACTS OF GBP 62,500)"
01/07/2008,GBP,1.9947,-1.21%,0.0121,5.86,3.04,89850,38184,40815,296,32366,21904,70846,63015,19004,26835,"(CONTRACTS OF GBP 62,500)"
24/06/2008,GBP,1.9708,-0.75%,0.0075,5.85,3,76375,24735,37578,257,37569,14829,62561,52664,13814,23711,"(CONTRACTS OF GBP 62,500)"
17/06/2008,GBP,1.9561,-0.10%,0.001,5.85,2.96,88496,20534,51782,28,48466,9086,69028,60896,19468,27600,"(CONTRACTS OF GBP 62,500)"
10/06/2008,GBP,1.9542,0.46%,-0.0046,5.75,2.92,176947,28040,49091,1615,130137,101916,159792,152622,17155,24325,"(CONTRACTS OF GBP 62,500)"
03/06/2008,GBP,1.9632,0.64%,-0.0064,5.75,3.07,162647,18580,47608,353,123891,90687,142824,138648,19823,23999,"(CONTRACTS OF GBP 62,500)"
27/05/2008,GBP,1.9759,-0.37%,0.0037,5.82,3.18,164058,22471,47359,39,126653,92447,149163,139845,14895,24213,"(CONTRACTS OF GBP 62,500)"
20/05/2008,GBP,1.9686,-1.23%,0.0122,5.83,3.19,160094,22233,47573,113,122488,87829,144834,135515,15260,24579,"(CONTRACTS OF GBP 62,500)"
13/05/2008,GBP,1.9447,1.45%,-0.0146,5.57,2.87,165843,25873,50677,107,123169,86329,149149,137113,16694,28730,"(CONTRACTS OF GBP 62,500)"
06/05/2008,GBP,1.9733,-0.19%,0.0019,5.66,2.89,144702,13874,44311,26,116349,75947,130249,120284,14453,24418,"(CONTRACTS OF GBP 62,500)"
29/04/2008,GBP,1.9695,1.28%,-0.0129,5.76,2.86,131121,21296,46144,26,96782,60014,118104,106184,13017,24937,"(CONTRACTS OF GBP 62,500)"
22/04/2008,GBP,1.9951,-1.66%,0.0164,5.82,2.82,115364,35044,30381,12,64051,62306,99107,92699,16257,22665,"(CONTRACTS OF GBP 62,500)"
15/04/2008,GBP,1.9626,0.29%,-0.003,5.81,3.06,113459,28219,44355,1,71190,44003,99410,88359,14049,25100,"(CONTRACTS OF GBP 62,500)"
08/04/2008,GBP,1.9684,0.36%,-0.0037,5.84,3.02,99529,30945,43505,1,52396,33227,83342,76733,16187,22796,"(CONTRACTS OF GBP 62,500)"
01/04/2008,GBP,1.9756,1.49%,-0.015,5.93,3.17,98868,34114,36874,652,47889,39044,82655,76570,16213,22298,"(CONTRACTS OF GBP 62,500)"
25/03/2008,GBP,2.0054,0.11%,-0.0011,5.83,3.24,78111,44244,24516,0,18361,34475,62605,58991,15506,19120,"(CONTRACTS OF GBP 62,500)"
18/03/2008,GBP,2.0076,-0.07%,0.0007,5.83,3.22,83249,49963,20823,0,16072,44020,66035,64843,17214,18406,"(CONTRACTS OF GBP 62,500)"
11/03/2008,GBP,2.0062,-1.02%,0.0102,5.68,2.91,109031,45149,23920,262,46685,61934,92096,86116,16935,22915,"(CONTRACTS OF GBP 62,500)"
04/03/2008,GBP,1.9859,0.00%,0,5.63,2.76,100067,38013,22299,157,40675,53988,78845,76444,21222,23623,"(CONTRACTS OF GBP 62,500)"
26/02/2008,GBP,1.9859,-1.95%,0.0193,5.61,2.54,95018,30642,27005,995,44831,42481,76468,70481,18550,24537,"(CONTRACTS OF GBP 62,500)"
19/02/2008,GBP,1.9479,0.69%,-0.007,5.62,2.55,94673,25606,37763,1722,49055,28235,76383,67720,18290,26953,"(CONTRACTS OF GBP 62,500)"
12/02/2008,GBP,1.9615,0.07%,-0.0007,5.63,2.73,96936,26593,40526,1546,51048,28609,79187,70681,17749,26255,"(CONTRACTS OF GBP 62,500)"
05/02/2008,GBP,1.9629,1.35%,-0.0136,5.53,2.57,93616,30757,38566,1788,44380,29039,76925,69393,16691,24223,"(CONTRACTS OF GBP 62,500)"
29/01/2008,GBP,1.9898,-1.45%,0.0144,5.57,2.33,92484,38888,33530,1004,37472,36282,77364,70816,15120,21668,"(CONTRACTS OF GBP 62,500)"
22/01/2008,GBP,1.9613,0.07%,-0.0007,5.42,2.1,93381,32239,32968,2406,41199,31556,75844,66930,17537,26451,"(CONTRACTS OF GBP 62,500)"
15/01/2008,GBP,1.9627,0.43%,-0.0043,5.57,1.62,84161,32740,32433,1387,30975,26447,65102,60267,19059,23894,"(CONTRACTS OF GBP 62,500)"
08/01/2008,GBP,1.9712,0.76%,-0.0076,5.63,1.34,86731,30569,33831,603,37955,29709,69127,64143,17604,22588,"(CONTRACTS OF GBP 62,500)"
31/12/2007,GBP,1.9863,-0.29%,0.0029,5.83,1.14,78638,29132,31941,609,34131,25342,63872,57892,14766,20746,"(CONTRACTS OF GBP 62,500)"
24/12/2007,GBP,1.9805,1.68%,-0.0169,5.98,1.23,74898,34590,25464,329,22055,28048,56974,53841,17924,21057,"(CONTRACTS OF GBP 62,500)"
18/12/2007,GBP,2.0143,0.95%,-0.0095,6.24,1.25,66527,32117,20580,494,17568,27293,50179,48367,16348,18160,"(CONTRACTS OF GBP 62,500)"
11/12/2007,GBP,2.0336,1.23%,-0.0124,6.53,1.25,157832,76851,19853,1055,62880,118164,140786,139072,17046,18760,"(CONTRACTS OF GBP 62,500)"
04/12/2007,GBP,2.0589,0.48%,-0.0048,6.54,1.35,117681,50879,19351,593,41968,77151,93440,97095,24241,20586,"(CONTRACTS OF GBP 62,500)"
27/11/2007,GBP,2.0689,-0.15%,0.0015,6.46,1.4,121270,56430,21368,975,42362,79383,99767,101726,21503,19544,"(CONTRACTS OF GBP 62,500)"
20/11/2007,GBP,2.0658,0.22%,-0.0022,6.38,1.48,122587,54350,19965,1391,44093,82937,99834,104293,22753,18294,"(CONTRACTS OF GBP 62,500)"
13/11/2007,GBP,2.0704,0.81%,-0.0081,6.23,1.43,123575,61661,18036,725,37168,85619,99554,104380,24021,19195,"(CONTRACTS OF GBP 62,500)"
06/11/2007,GBP,2.0873,-1.01%,0.01,6.11,1.3,147306,79840,19514,624,40375,107261,120839,127399,26467,19907,"(CONTRACTS OF GBP 62,500)"
30/10/2007,GBP,2.0665,-0.78%,0.0078,6.14,1.41,138550,70484,17556,5,41169,100625,111658,118186,26892,20364,"(CONTRACTS OF GBP 62,500)"
23/10/2007,GBP,2.0505,-0.93%,0.0093,6.18,1.3,124112,62712,17291,107,37192,87488,100011,104886,24101,19226,"(CONTRACTS OF GBP 62,500)"
16/10/2007,GBP,2.0316,0.31%,-0.0031,6.17,1.05,108213,56067,20363,984,25165,68929,82216,90276,25997,17937,"(CONTRACTS OF GBP 62,500)"
09/10/2007,GBP,2.038,0.14%,-0.0014,6.13,0.98,108741,54137,23649,327,29526,66654,83990,90630,24751,18111,"(CONTRACTS OF GBP 62,500)"
02/10/2007,GBP,2.0409,-1.11%,0.011,6.14,0.85,98589,55395,28841,437,19246,51165,75078,80443,23511,18146,"(CONTRACTS OF GBP 62,500)"
25/09/2007,GBP,2.0185,-0.32%,0.0032,6.23,0.99,85124,47380,22823,356,17251,46447,64987,69626,20137,15498,"(CONTRACTS OF GBP 62,500)"
18/09/2007,GBP,2.012,0.99%,-0.01,6.63,1.43,78793,38917,25524,1084,17150,36868,57151,63476,21642,15317,"(CONTRACTS OF GBP 62,500)"
11/09/2007,GBP,2.0322,-0.96%,0.0096,6.81,1.1,143188,62069,20478,4609,51229,99555,117907,124642,25281,18546,"(CONTRACTS OF GBP 62,500)"
04/09/2007,GBP,2.0128,-0.56%,0.0056,6.6,0.87,125940,53176,20602,1362,48925,86940,103463,108904,22477,17036,"(CONTRACTS OF GBP 62,500)"
28/08/2007,GBP,2.0016,-1.03%,0.0103,6.42,0.96,123570,55525,20954,1237,45882,85074,102644,107265,20926,16305,"(CONTRACTS OF GBP 62,500)"
21/08/2007,GBP,1.9811,0.77%,-0.0077,6.62,1.17,117568,48830,19691,1988,43213,78402,94031,100081,23537,17487,"(CONTRACTS OF GBP 62,500)"
14/08/2007,GBP,1.9965,1.24%,-0.0125,6.05,0.56,120623,58864,17506,1935,32309,83052,93108,102493,27515,18130,"(CONTRACTS OF GBP 62,500)"
07/08/2007,GBP,2.0216,0.34%,-0.0034,6.02,0.7,125762,74315,20182,884,23108,84134,98307,105200,27455,20562,"(CONTRACTS OF GBP 62,500)"
31/07/2007,GBP,2.0285,1.62%,-0.0163,5.96,0.66,128722,89522,20809,732,9372,86690,99626,108231,29096,20491,"(CONTRACTS OF GBP 62,500)"
24/07/2007,GBP,2.0619,-0.75%,0.0074,5.96,0.65,158955,107615,24111,539,16700,110055,124854,134705,34101,24250,"(CONTRACTS OF GBP 62,500)"
17/07/2007,GBP,2.0466,-0.99%,0.0098,5.92,0.61,173222,123452,25086,685,16579,124035,140716,149806,32506,23416,"(CONTRACTS OF GBP 62,500)"
10/07/2007,GBP,2.0266,-0.51%,0.005,5.92,0.6,156362,112950,24419,548,8054,105737,121552,130704,34810,25658,"(CONTRACTS OF GBP 62,500)"
03/07/2007,GBP,2.0164,-0.89%,0.0088,5.92,0.63,164639,122379,24206,668,8765,113388,131812,138262,32827,26377,"(CONTRACTS OF GBP 62,500)"
26/06/2007,GBP,1.9987,-0.54%,0.0054,5.77,0.51,159791,119328,23194,412,9501,117340,129241,140946,30550,18845,"(CONTRACTS OF GBP 62,500)"
19/06/2007,GBP,1.9879,-0.70%,0.007,5.75,0.46,133035,92943,21250,265,13029,93387,106237,114902,26798,18133,"(CONTRACTS OF GBP 62,500)"
12/06/2007,GBP,1.9741,0.95%,-0.0095,5.79,0.51,133395,63644,24227,3755,39569,84461,106968,112443,26427,20952,"(CONTRACTS OF GBP 62,500)"
05/06/2007,GBP,1.993,-0.61%,0.0061,5.78,0.5,142314,85999,24139,514,22388,97239,108901,121892,33413,20422,"(CONTRACTS OF GBP 62,500)"
29/05/2007,GBP,1.9809,-0.31%,0.0031,5.7,0.41,129528,69948,22538,51,27631,87821,97630,110410,31898,19118,"(CONTRACTS OF GBP 62,500)"
22/05/2007,GBP,1.9748,0.56%,-0.0056,5.72,0.46,122261,56493,21155,10,35585,82060,92088,103225,30173,19036,"(CONTRACTS OF GBP 62,500)"
15/05/2007,GBP,1.9859,0.15%,-0.0015,5.68,0.42,126092,64011,22933,273,32792,82193,97076,105399,29016,20693,"(CONTRACTS OF GBP 62,500)"
08/05/2007,GBP,1.9889,0.50%,-0.005,5.68,0.42,134140,74982,22985,56,26075,91768,101113,114809,33027,19331,"(CONTRACTS OF GBP 62,500)"
01/05/2007,GBP,1.9989,0.15%,-0.0015,5.61,0.35,144051,88457,24464,82,22501,97649,111040,122195,33011,21856,"(CONTRACTS OF GBP 62,500)"
24/04/2007,GBP,2.0019,0.29%,-0.0029,5.58,0.33,148006,95965,25899,145,19622,99196,115732,125240,32274,22766,"(CONTRACTS OF GBP 62,500)"
17/04/2007,GBP,2.0078,-1.81%,0.0179,5.54,0.27,134953,83429,23762,369,18904,85161,102702,109292,32251,25661,"(CONTRACTS OF GBP 62,500)"
10/04/2007,GBP,1.9722,0.12%,-0.0012,5.48,0.22,120468,70095,21678,124,22147,77490,92366,99292,28102,21176,"(CONTRACTS OF GBP 62,500)"
03/04/2007,GBP,1.9746,-0.50%,0.005,5.51,0.26,122932,73343,17500,65,18437,84038,91845,101603,31087,21329,"(CONTRACTS OF GBP 62,500)"
27/03/2007,GBP,1.9648,-0.19%,0.0019,5.52,0.27,111802,63269,20691,0,17817,73446,81086,94137,30716,17665,"(CONTRACTS OF GBP 62,500)"
20/03/2007,GBP,1.9611,-1.70%,0.0169,5.49,0.24,111646,66091,19962,0,18174,71481,84265,91443,27381,20203,"(CONTRACTS OF GBP 62,500)"
13/03/2007,GBP,1.9283,0.12%,-0.0012,5.37,0.12,160560,49742,29339,2402,79416,107339,131560,139080,29000,21480,"(CONTRACTS OF GBP 62,500)"
06/03/2007,GBP,1.9307,1.55%,-0.0156,5.43,0.17,152524,57219,29826,583,65622,101299,123424,131708,29100,20816,"(CONTRACTS OF GBP 62,500)"
27/02/2007,GBP,1.961,-0.29%,0.0029,5.44,0.19,160234,88313,20285,234,32722,115740,121269,136259,38965,23975,"(CONTRACTS OF GBP 62,500)"
20/02/2007,GBP,1.9553,-0.43%,0.0043,5.41,0.11,147702,74776,15623,19,39292,109087,114087,124729,33615,22973,"(CONTRACTS OF GBP 62,500)"
13/02/2007,GBP,1.9469,1.20%,-0.0121,5.43,0.13,150695,66582,17984,504,48283,108402,115369,126890,35326,23805,"(CONTRACTS OF GBP 62,500)"
06/02/2007,GBP,1.9706,-0.40%,0.004,5.55,0.25,162238,106463,13735,484,20125,127221,127072,141440,35166,20798,"(CONTRACTS OF GBP 62,500)"
30/01/2007,GBP,1.9627,0.96%,-0.0097,5.49,0.19,146660,87825,10898,24,22685,113545,110534,124467,36126,22193,"(CONTRACTS OF 62,500 POUNDS STERLING)"
23/01/2007,GBP,1.9818,-1.06%,0.0105,5.53,0.26,163961,109941,15213,0,15408,127877,125349,143090,38612,20871,"(CONTRACTS OF 62,500 POUNDS STERLING)"
16/01/2007,GBP,1.9611,-1.12%,0.0112,5.46,0.2,150691,96664,12346,275,16121,117006,113060,129627,37631,21064,"(CONTRACTS OF 62,500 POUNDS STERLING)"
09/01/2007,GBP,1.9393,1.72%,-0.0174,5.26,-0.03,132731,69319,10666,493,27593,101064,97405,112223,35326,20508,"(CONTRACTS OF 62,500 POUNDS STERLING)"
03/01/2007,GBP,1.9733,-0.98%,0.0098,5.22,-0.04,137217,79060,13903,390,22259,105465,101709,119758,35508,17459,"(CONTRACTS OF 62,500 POUNDS STERLING)"
26/12/2006,GBP,1.9541,0.72%,-0.0072,5.25,-0.05,140289,86236,12392,2,20724,114599,106962,126993,33327,13296,"(CONTRACTS OF 62,500 POUNDS STERLING)"
19/12/2006,GBP,1.9683,0.12%,-0.0012,5.2,-0.1,149800,98434,12836,342,18196,121133,116972,134311,32828,15489,"(CONTRACTS OF 62,500 POUNDS STERLING)"
12/12/2006,GBP,1.9707,0.15%,-0.0015,5.18,-0.11,181580,103761,24592,3051,38842,136975,145654,164618,35926,16962,"(CONTRACTS OF 62,500 POUNDS STERLING)"
05/12/2006,GBP,1.9737,-1.08%,0.0107,5.19,-0.09,151959,96711,20879,1833,17011,109218,115555,131930,36404,20029,"(CONTRACTS OF 62,500 POUNDS STERLING)"
28/11/2006,GBP,1.9526,-2.81%,0.0277,5.14,-0.13,154081,101064,20438,818,17185,112569,119067,133825,35014,20256,"(CONTRACTS OF 62,500 POUNDS STERLING)"
21/11/2006,GBP,1.8992,-0.17%,0.0017,5.12,-0.14,140587,90136,21047,530,16559,102108,107225,123685,33362,16902,"(CONTRACTS OF 62,500 POUNDS STERLING)"
14/11/2006,GBP,1.8959,0.50%,-0.005,5.14,-0.15,136600,82682,20430,401,21104,99405,104187,120236,32413,16364,"(CONTRACTS OF 62,500 POUNDS STERLING)"
07/11/2006,GBP,1.9054,0.10%,-0.001,5.12,-0.16,152030,104189,19909,168,16385,113267,120742,133344,31288,18686,"(CONTRACTS OF 62,500 POUNDS STERLING)"
31/10/2006,GBP,1.9074,-1.83%,0.0181,5.11,-0.16,126678,80509,20645,173,16971,85465,97653,106283,29025,20395,"(CONTRACTS OF 62,500 POUNDS STERLING)"
24/10/2006,GBP,1.8731,-0.15%,0.0015,5.09,-0.19,101676,56205,19040,568,21300,65613,78073,85221,23603,16455,"(CONTRACTS OF 62,500 POUNDS STERLING)"
17/10/2006,GBP,1.8703,-0.86%,0.0085,5.05,-0.22,108510,56447,23142,0,26843,66137,83290,89279,25220,19231,"(CONTRACTS OF 62,500 POUNDS STERLING)"
10/10/2006,GBP,1.8544,1.75%,-0.0177,5.03,-0.28,101848,44433,24598,308,29949,59055,74690,83961,27158,17887,"(CONTRACTS OF 62,500 POUNDS STERLING)"
03/10/2006,GBP,1.8875,0.36%,-0.0036,5.02,-0.29,104665,62700,17754,0,17176,71158,79876,88912,24789,15753,"(CONTRACTS OF 62,500 POUNDS STERLING)"
26/09/2006,GBP,1.8943,-0.70%,0.0069,4.97,-0.32,122122,74642,17675,0,17207,89109,91849,106784,30273,15338,"(CONTRACTS OF 62,500 POUNDS STERLING)"
19/09/2006,GBP,1.8812,-0.39%,0.0039,4.97,-0.36,104255,60218,17265,92,18723,72331,79033,89688,25222,14567,"(CONTRACTS OF 62,500 POUNDS STERLING)"
12/09/2006,GBP,1.8739,1.07%,-0.0107,4.93,-0.41,127633,50259,12678,5425,43986,88470,99670,106573,27963,21060,"(CONTRACTS OF 62,500 POUNDS STERLING)"
05/09/2006,GBP,1.8941,0.24%,-0.0024,4.89,-0.43,131836,63587,9655,20,37607,104080,101214,113755,30622,18081,"(CONTRACTS OF 62,500 POUNDS STERLING)"
29/08/2006,GBP,1.8986,-0.53%,0.0053,4.86,-0.48,130539,66676,10551,80,31850,104355,98606,114986,31933,15553,"(CONTRACTS OF 62,500 POUNDS STERLING)"
22/08/2006,GBP,1.8886,0.27%,-0.0027,4.88,-0.46,127943,66586,9770,53,30487,102648,97126,112471,30817,15472,"(CONTRACTS OF 62,500 POUNDS STERLING)"
15/08/2006,GBP,1.8938,0.71%,-0.0072,4.87,-0.48,135944,74152,10956,50,27206,109568,101408,120574,34536,15370,"(CONTRACTS OF 62,500 POUNDS STERLING)"
08/08/2006,GBP,1.9074,-1.66%,0.0164,4.88,-0.51,128112,65228,9602,3,30603,101574,95834,111179,32278,16933,"(CONTRACTS OF 62,500 POUNDS STERLING)"
01/08/2006,GBP,1.8763,-2.01%,0.0199,4.71,-0.71,114075,56297,11294,43,27756,87974,84096,99311,29979,14764,"(CONTRACTS OF 62,500 POUNDS STERLING)"
25/07/2006,GBP,1.8393,-0.73%,0.0073,4.68,-0.75,102104,34685,12026,3,43032,76575,77720,88604,24384,13500,"(CONTRACTS OF 62,500 POUNDS STERLING)"
18/07/2006,GBP,1.826,1.08%,-0.0108,4.59,-0.86,88080,28460,11383,5,35604,62241,64069,73629,24011,14451,"(CONTRACTS OF 62,500 POUNDS STERLING)"
11/07/2006,GBP,1.8459,-0.07%,0.0007,4.61,-0.85,85671,25268,11519,2,35168,61681,60438,73202,25233,12469,"(CONTRACTS OF 62,500 POUNDS STERLING)"
03/07/2006,GBP,1.8447,-1.25%,0.0124,4.64,-0.79,78658,22169,10306,1,34262,55238,56432,65545,22226,13113,"(CONTRACTS OF 62,500 POUNDS STERLING)"
27/06/2006,GBP,1.822,1.08%,-0.0109,4.66,-0.8,78592,17709,11138,42,38284,53525,56035,64705,22557,13887,"(CONTRACTS OF 62,500 POUNDS STERLING)"
20/06/2006,GBP,1.8419,-0.49%,0.0048,4.65,-0.73,78491,29010,5608,130,26575,61283,55715,67021,22776,11470,"(CONTRACTS OF 62,500 POUNDS STERLING)"
13/06/2006,GBP,1.833,1.43%,-0.0144,4.64,-0.64,126043,34221,12127,690,63665,98305,98576,111122,27467,14921,"(CONTRACTS OF 62,500 POUNDS STERLING)"
06/06/2006,GBP,1.8595,1.33%,-0.0134,4.63,-0.59,105314,33771,11485,81,42204,79213,76056,90779,29258,14535,"(CONTRACTS OF 62,500 POUNDS STERLING)"
30/05/2006,GBP,1.8845,-0.26%,0.0026,4.61,-0.57,112099,51965,12268,50,30254,83711,82269,96029,29830,16070,"(CONTRACTS OF 62,500 POUNDS STERLING)"
23/05/2006,GBP,1.8796,0.44%,-0.0045,4.61,-0.54,114772,42928,12370,116,40784,87163,83828,99649,30944,15123,"(CONTRACTS OF 62,500 POUNDS STERLING)"
16/05/2006,GBP,1.888,-1.12%,0.0112,4.61,-0.51,110006,39358,15086,430,39736,78830,79524,94346,30482,15660,"(CONTRACTS OF 62,500 POUNDS STERLING)"
09/05/2006,GBP,1.867,-1.46%,0.0145,4.61,-0.5,104008,41071,15304,98,32834,71023,74003,86425,30005,17583,"(CONTRACTS OF 62,500 POUNDS STERLING)"
02/05/2006,GBP,1.8401,-2.94%,0.029,4.59,-0.51,89073,34133,15509,84,31213,58070,65430,73663,23643,15410,"(CONTRACTS OF 62,500 POUNDS STERLING)"
25/04/2006,GBP,1.7875,-0.26%,0.0026,4.57,-0.48,93662,35005,22715,19,34973,52796,69997,75530,23665,18132,"(CONTRACTS OF 62,500 POUNDS STERLING)"
18/04/2006,GBP,1.7828,-1.94%,0.0192,4.53,-0.5,83282,27302,22208,304,33982,41930,61588,64442,21694,18840,"(CONTRACTS OF 62,500 POUNDS STERLING)"
11/04/2006,GBP,1.7489,0.32%,-0.0033,4.53,-0.47,79127,16971,22595,0,42536,37687,59507,60282,19620,18845,"(CONTRACTS OF 62,500 POUNDS STERLING)"
04/04/2006,GBP,1.7546,-0.64%,0.0064,4.54,-0.43,79371,14015,24699,0,48888,32217,62903,56916,16468,22455,"(CONTRACTS OF 62,500 POUNDS STERLING)"
28/03/2006,GBP,1.7434,0.19%,-0.0019,4.52,-0.4,67999,12491,18775,274,41984,27751,54749,46800,13250,21199,"(CONTRACTS OF 62,500 POUNDS STERLING)"
21/03/2006,GBP,1.7468,-0.03%,0.0003,4.51,-0.35,68099,13183,18418,27,39994,30911,53204,49356,14895,18743,"(CONTRACTS OF 62,500 POUNDS STERLING)"
14/03/2006,GBP,1.7463,-0.59%,0.0059,4.47,-0.39,70017,10989,25621,10,44935,22224,55934,47855,14083,22162,"(CONTRACTS OF 62,500 POUNDS STERLING)"
07/03/2006,GBP,1.736,1.01%,-0.0102,4.5,-0.29,105166,14981,27325,12,71871,52999,86864,80336,18302,24830,"(CONTRACTS OF 62,500 POUNDS STERLING)"
28/02/2006,GBP,1.7538,-0.46%,0.0046,4.46,-0.27,98756,15055,23244,131,66047,55160,81233,78535,17523,20221,"(CONTRACTS OF 62,500 POUNDS STERLING)"
21/02/2006,GBP,1.7458,-0.55%,0.0055,4.48,-0.24,97217,14722,34603,42,66600,39946,81364,74591,15853,22626,"(CONTRACTS OF 62,500 POUNDS STERLING)"
14/02/2006,GBP,1.7362,0.40%,-0.004,4.47,-0.21,99687,12019,36663,203,71768,38093,83990,74959,15697,24728,"(CONTRACTS OF 62,500 POUNDS STERLING)"
07/02/2006,GBP,1.7432,2.00%,-0.0202,4.51,-0.13,93793,15492,29554,41,62786,43168,78319,72763,15474,21030,"(CONTRACTS OF 62,500 POUNDS STERLING)"
31/01/2006,GBP,1.7787,0.35%,-0.0035,4.51,-0.17,94091,21296,23206,111,53808,51561,75215,74878,18876,19213,"(CONTRACTS OF 62,500 POUNDS STERLING)"
24/01/2006,GBP,1.785,-1.00%,0.0099,4.5,-0.04,89537,22028,19180,35,47377,52493,69440,71708,20097,17829,"(CONTRACTS OF 62,500 POUNDS STERLING)"
17/01/2006,GBP,1.7674,-0.12%,0.0012,4.51,-0.06,83135,17411,20714,6,48630,45024,66047,65744,17088,17391,"(CONTRACTS OF 62,500 POUNDS STERLING)"
10/01/2006,GBP,1.7653,-1.17%,0.0117,4.51,-0.02,77079,17074,21847,6,45988,36928,63068,58781,14011,18298,"(CONTRACTS OF 62,500 POUNDS STERLING)"
03/01/2006,GBP,1.7448,-1.02%,0.0101,4.54,0.01,69591,13026,28047,87,42720,20271,55833,48405,13758,21186,"(CONTRACTS OF 62,500 POUNDS STERLING)"
27/12/2005,GBP,1.7272,1.48%,-0.0149,4.56,0.05,62736,9474,21067,0,37989,25091,47463,46158,15273,16578,"(CONTRACTS OF 62,500 POUNDS STERLING)"
20/12/2005,GBP,1.7531,0.91%,-0.0091,4.56,0.08,70230,9425,17617,95,43997,36623,53517,54335,16713,15895,"(CONTRACTS OF 62,500 POUNDS STERLING)"
13/12/2005,GBP,1.7692,-1.60%,0.0158,4.58,0.18,111268,13586,21442,824,79828,69931,94238,92197,17030,19071,"(CONTRACTS OF 62,500 POUNDS STERLING)"
06/12/2005,GBP,1.7414,-1.29%,0.0128,4.56,0.18,107224,15567,41346,384,74048,41828,89999,83558,17225,23666,"(CONTRACTS OF 62,500 POUNDS STERLING)"
29/11/2005,GBP,1.7192,0.12%,-0.0012,4.53,0.2,100047,10936,44023,51,71758,32648,82745,76722,17302,23325,"(CONTRACTS OF 62,500 POUNDS STERLING)"
22/11/2005,GBP,1.7213,0.77%,-0.0078,4.52,0.19,89837,9056,42076,0,63136,22728,72192,64804,17645,25033,"(CONTRACTS OF 62,500 POUNDS STERLING)"
15/11/2005,GBP,1.7347,0.46%,-0.0047,4.53,0.24,84441,10175,33992,4,58210,27537,68389,61533,16052,22908,"(CONTRACTS OF 62,500 POUNDS STERLING)"
08/11/2005,GBP,1.7428,1.25%,-0.0125,4.52,0.26,80390,10489,29859,4,53470,28012,63963,57875,16427,22515,"(CONTRACTS OF 62,500 POUNDS STERLING)"
01/11/2005,GBP,1.7648,1.10%,-0.011,4.52,0.31,69583,9163,23472,6,44419,27284,53588,50762,15995,18821,"(CONTRACTS OF 62,500 POUNDS STERLING)"
25/10/2005,GBP,1.7844,-1.90%,0.0188,4.5,0.34,74286,12541,26582,180,44302,29131,57023,55893,17263,18393,"(CONTRACTS OF 62,500 POUNDS STERLING)"
18/10/2005,GBP,1.7511,-0.29%,0.0029,4.49,0.39,83729,10591,31641,4,53424,27988,64019,59633,19710,24096,"(CONTRACTS OF 62,500 POUNDS STERLING)"
11/10/2005,GBP,1.746,0.72%,-0.0072,4.46,0.41,89400,13716,36761,4,56373,32485,70093,69250,19307,20150,"(CONTRACTS OF 62,500 POUNDS STERLING)"
04/10/2005,GBP,1.7586,0.46%,-0.0046,4.5,0.48,89889,20074,36934,4,53557,34590,73635,71528,16254,18361,"(CONTRACTS OF 62,500 POUNDS STERLING)"
27/09/2005,GBP,1.7667,1.76%,-0.0177,4.51,0.58,77440,27581,25018,63,30404,35853,58048,60934,19392,16506,"(CONTRACTS OF 62,500 POUNDS STERLING)"
20/09/2005,GBP,1.7983,1.31%,-0.0132,4.52,0.65,67785,24572,13994,4,22488,41168,47064,55166,20721,12619,"(CONTRACTS OF 62,500 POUNDS STERLING)"
13/09/2005,GBP,1.8222,1.07%,-0.0108,4.5,0.74,91701,27410,8935,768,40858,67154,69036,76857,22665,14844,"(CONTRACTS OF 62,500 POUNDS STERLING)"
06/09/2005,GBP,1.842,-3.13%,0.0308,4.45,0.76,80522,25940,14944,61,37604,61913,63605,76918,16917,3604,"(CONTRACTS OF 62,500 POUNDS STERLING)"
30/08/2005,GBP,1.7861,0.82%,-0.0082,4.44,0.68,77596,18388,20599,20,45034,47384,63442,68003,14154,9593,"(CONTRACTS OF 62,500 POUNDS STERLING)"
23/08/2005,GBP,1.8008,0.55%,-0.0055,4.5,0.72,74604,21708,16210,48,34611,41919,56367,58177,18237,16427,"(CONTRACTS OF 62,500 POUNDS STERLING)"
16/08/2005,GBP,1.8107,-1.31%,0.013,4.5,0.76,72786,20459,18101,47,34085,35992,54591,54140,18195,18646,"(CONTRACTS OF 62,500 POUNDS STERLING)"
09/08/2005,GBP,1.7873,-0.89%,0.0089,4.49,0.8,72461,11090,26599,113,44467,24323,55670,51035,16791,21426,"(CONTRACTS OF 62,500 POUNDS STERLING)"
02/08/2005,GBP,1.7715,-1.97%,0.0195,4.53,0.87,73519,12377,29356,89,43456,22949,55922,52394,17597,21125,"(CONTRACTS OF 62,500 POUNDS STERLING)"
26/07/2005,GBP,1.7373,0.16%,-0.0016,4.54,0.92,75763,12276,32141,23,46338,23720,58637,55884,17126,19879,"(CONTRACTS OF 62,500 POUNDS STERLING)"
19/07/2005,GBP,1.74,2.15%,-0.0218,4.56,0.99,77596,11268,36892,10,48718,21784,59996,58686,17600,18910,"(CONTRACTS OF 62,500 POUNDS STERLING)"
12/07/2005,GBP,1.7783,-1.24%,0.0123,4.57,1.03,74117,9067,31648,10,48017,22292,57094,53950,17023,20167,"(CONTRACTS OF 62,500 POUNDS STERLING)"
05/07/2005,GBP,1.7565,3.17%,-0.0322,4.64,1.11,73218,10990,31404,0,42063,23347,53053,54751,20165,18467,"(CONTRACTS OF 62,500 POUNDS STERLING)"
28/06/2005,GBP,1.814,0.82%,-0.0082,4.7,1.29,66998,8962,28767,175,40945,19759,50082,48701,16916,18297,"(CONTRACTS OF 62,500 POUNDS STERLING)"
21/06/2005,GBP,1.829,-1.24%,0.0123,4.8,1.37,65232,13979,26898,175,33746,20696,47900,47769,17332,17463,"(CONTRACTS OF 62,500 POUNDS STERLING)"
14/06/2005,GBP,1.8066,1.54%,-0.0155,4.77,1.42,68775,14197,31146,543,36280,18422,51020,50111,17755,18664,"(CONTRACTS OF 62,500 POUNDS STERLING)"
07/06/2005,GBP,1.8348,-0.95%,0.0095,4.73,1.43,101520,14668,23243,723,62055,57244,77446,81210,24074,20310,"(CONTRACTS OF 62,500 POUNDS STERLING)"
31/05/2005,GBP,1.8175,0.53%,-0.0053,4.76,1.49,95073,14346,25417,793,61489,48354,76628,74564,18445,20509,"(CONTRACTS OF 62,500 POUNDS STERLING)"
24/05/2005,GBP,1.8271,0.35%,-0.0035,4.78,1.59,86387,14760,22170,805,52624,45652,68189,68627,18198,17760,"(CONTRACTS OF 62,500 POUNDS STERLING)"
17/05/2005,GBP,1.8335,2.58%,-0.0262,4.77,1.6,81490,17615,17181,680,43338,47680,61633,65541,19857,15949,"(CONTRACTS OF 62,500 POUNDS STERLING)"
10/05/2005,GBP,1.8821,0.51%,-0.0051,4.79,1.61,89238,25907,5809,15,40597,70896,66519,76720,22719,12518,"(CONTRACTS OF 62,500 POUNDS STERLING)"
03/05/2005,GBP,1.8917,0.75%,-0.0075,4.82,1.69,88941,25845,5967,1,38817,73461,64663,79429,24278,9512,"(CONTRACTS OF 62,500 POUNDS STERLING)"
26/04/2005,GBP,1.9059,0.63%,-0.0063,4.83,1.73,85465,29282,5571,1,33392,70335,62675,75907,22790,9558,"(CONTRACTS OF 62,500 POUNDS STERLING)"
19/04/2005,GBP,1.9179,-1.37%,0.0136,4.85,1.83,86549,33817,7019,29,33679,68760,67525,75808,19024,10741,"(CONTRACTS OF 62,500 POUNDS STERLING)"
12/04/2005,GBP,1.8919,-0.62%,0.0062,4.8,1.71,82524,26824,6453,1,37784,64686,64609,71140,17915,11384,"(CONTRACTS OF 62,500 POUNDS STERLING)"
05/04/2005,GBP,1.8802,-0.35%,0.0035,4.87,1.86,68416,21540,6056,57,28210,51168,49807,57281,18609,11135,"(CONTRACTS OF 62,500 POUNDS STERLING)"
29/03/2005,GBP,1.8737,0.63%,-0.0063,4.9,1.86,66380,18587,6713,1,27558,47831,46146,54545,20234,11835,"(CONTRACTS OF 62,500 POUNDS STERLING)"
22/03/2005,GBP,1.8855,1.37%,-0.0137,4.87,1.91,71769,31332,4677,87,16237,56958,47656,61722,24113,10047,"(CONTRACTS OF 62,500 POUNDS STERLING)"
15/03/2005,GBP,1.9116,0.89%,-0.009,4.89,1.95,79439,42006,4182,32,9867,65961,51905,70175,27534,9264,"(CONTRACTS OF 62,500 POUNDS STERLING)"
08/03/2005,GBP,1.9288,-0.44%,0.0044,4.89,2.04,99583,46451,5324,1569,21121,80602,69141,87495,30442,12088,"(CONTRACTS OF 62,500 POUNDS STERLING)"
01/03/2005,GBP,1.9204,-0.52%,0.0052,4.82,1.97,79910,38182,4663,34,15806,62860,54022,67557,25888,12353,"(CONTRACTS OF 62,500 POUNDS STERLING)"
22/02/2005,GBP,1.9105,-0.73%,0.0073,4.76,1.93,79178,29369,4213,24,26278,63025,55671,67262,23507,11916,"(CONTRACTS OF 62,500 POUNDS STERLING)"
15/02/2005,GBP,1.8966,-2.26%,0.0224,4.81,2.07,73291,26973,4734,655,25016,56475,52644,61864,20647,11427,"(CONTRACTS OF 62,500 POUNDS STERLING)"
08/02/2005,GBP,1.8546,1.53%,-0.0155,4.77,2.08,64686,15190,5081,369,28999,45861,44558,51311,20128,13375,"(CONTRACTS OF 62,500 POUNDS STERLING)"
01/02/2005,GBP,1.8835,-1.05%,0.0104,4.76,2.05,65926,19591,2898,494,24406,49927,44491,53319,21435,12607,"(CONTRACTS OF 62,500 POUNDS STERLING)"
25/01/2005,GBP,1.864,0.15%,-0.0015,4.74,2.1,63971,18616,2626,47,23465,45528,42128,48201,21843,15770,"(CONTRACTS OF 62,500 POUNDS STERLING)"
18/01/2005,GBP,1.8668,0.60%,-0.006,4.73,2.13,64508,21007,2292,13,21563,47502,42583,49807,21925,14701,"(CONTRACTS OF 62,500 POUNDS STERLING)"
11/01/2005,GBP,1.8781,0.20%,-0.002,4.75,2.18,66467,22756,1364,13,22216,51666,44985,53043,21482,13424,"(CONTRACTS OF 62,500 POUNDS STERLING)"
04/01/2005,GBP,1.8819,2.36%,-0.0239,4.76,2.24,75999,24458,11935,13,27277,51423,51748,63371,24251,12628,"(CONTRACTS OF 62,500 POUNDS STERLING)"
28/12/2004,GBP,1.9274,0.04%,-0.0004,4.75,2.29,77644,33131,12980,0,19585,53575,52716,66555,24928,11089,"(CONTRACTS OF 62,500 POUNDS STERLING)"
21/12/2004,GBP,1.9282,0.00%,0,4.79,2.33,81082,37492,2710,0,17589,66448,55081,69158,26001,11924,"(CONTRACTS OF 62,500 POUNDS STERLING)"
14/12/2004,GBP,1.9282,0.88%,-0.0088,4.72,2.31,77331,41235,2449,0,10798,64146,52033,66595,25298,10736,"(CONTRACTS OF 62,500 POUNDS STERLING)"
07/12/2004,GBP,1.9453,-1.81%,0.0179,4.77,2.4,101414,39467,5882,100,33945,82309,73512,88291,27902,13123,"(CONTRACTS OF 62,500 POUNDS STERLING)"
30/11/2004,GBP,1.9107,-2.32%,0.023,4.74,2.4,88044,44296,11521,0,14122,62951,58418,74472,29626,13572,"(CONTRACTS OF 62,500 POUNDS STERLING)"
23/11/2004,GBP,1.8673,-0.80%,0.008,4.75,2.47,97094,47600,13995,2,20643,71328,68245,85325,28849,11769,"(CONTRACTS OF 62,500 POUNDS STERLING)"
16/11/2004,GBP,1.8525,0.23%,-0.0023,4.77,2.53,88817,42409,14760,0,20487,62901,62896,77661,25921,11156,"(CONTRACTS OF 62,500 POUNDS STERLING)"
09/11/2004,GBP,1.8568,-0.95%,0.0094,4.81,2.6,88825,40588,17242,3,22072,61175,62663,78420,26162,10405,"(CONTRACTS OF 62,500 POUNDS STERLING)"
02/11/2004,GBP,1.8394,-0.31%,0.0031,4.8,2.7,75805,29594,16252,3,22776,49666,52373,65921,23432,9884,"(CONTRACTS OF 62,500 POUNDS STERLING)"
26/10/2004,GBP,1.8337,-1.64%,0.0162,4.82,2.78,72410,24758,15233,5,23329,47683,48092,62921,24318,9489,"(CONTRACTS OF 62,500 POUNDS STERLING)"
19/10/2004,GBP,1.8042,-0.74%,0.0074,4.81,2.81,66763,14932,16633,89,30135,37423,45156,54145,21607,12618,"(CONTRACTS OF 62,500 POUNDS STERLING)"
12/10/2004,GBP,1.7909,-0.51%,0.005,4.75,2.78,64539,12458,16631,303,33400,34207,46161,51141,18378,13398,"(CONTRACTS OF 62,500 POUNDS STERLING)"
05/10/2004,GBP,1.7819,1.73%,-0.0174,4.81,2.84,59892,14877,14851,39,26924,31085,41840,45975,18052,13917,"(CONTRACTS OF 62,500 POUNDS STERLING)"
28/09/2004,GBP,1.8132,-0.92%,0.0091,4.82,2.95,55643,16311,8495,168,21679,33503,38158,42166,17485,13477,"(CONTRACTS OF 62,500 POUNDS STERLING)"
21/09/2004,GBP,1.7967,-0.07%,0.0007,4.86,3.02,46702,12471,6469,372,19094,24786,31937,31627,14765,15075,"(CONTRACTS OF 62,500 POUNDS STERLING)"
14/09/2004,GBP,1.7955,-1.23%,0.0123,4.81,3.02,46188,12072,6063,377,17444,25125,29893,31565,16295,14623,"(CONTRACTS OF 62,500 POUNDS STERLING)"
07/09/2004,GBP,1.7736,1.59%,-0.016,4.82,3.07,81067,10778,9031,385,51485,52981,62648,62397,18419,18670,"(CONTRACTS OF 62,500 POUNDS STERLING)"
31/08/2004,GBP,1.8022,-0.54%,0.0053,4.84,3.13,74825,15120,8031,635,39722,49584,55477,58250,19348,16575,"(CONTRACTS OF 62,500 POUNDS STERLING)"
24/08/2004,GBP,1.7926,1.94%,-0.0196,4.84,3.2,72156,14581,7322,195,37186,50712,51962,58229,20194,13927,"(CONTRACTS OF 62,500 POUNDS STERLING)"
17/08/2004,GBP,1.828,-0.09%,0.0009,4.93,3.21,74776,24266,5068,96,28114,58031,52476,63195,22300,11581,"(CONTRACTS OF 62,500 POUNDS STERLING)"
10/08/2004,GBP,1.8263,-0.07%,0.0007,4.86,3.19,69615,28155,5439,96,19716,52827,47967,58362,21648,11253,"(CONTRACTS OF 62,500 POUNDS STERLING)"
03/08/2004,GBP,1.825,-0.20%,0.002,4.86,3.15,70933,26238,4632,57,20324,54601,46619,59290,24314,11643,"(CONTRACTS OF 62,500 POUNDS STERLING)"
27/07/2004,GBP,1.8214,1.64%,-0.0165,4.85,3.28,67259,27913,3418,202,14967,51429,43082,55049,24177,12210,"(CONTRACTS OF 62,500 POUNDS STERLING)"
20/07/2004,GBP,1.8517,0.27%,-0.0027,4.76,3.24,79820,37000,5233,52,14143,62957,51195,68242,28625,11578,"(CONTRACTS OF 62,500 POUNDS STERLING)"
13/07/2004,GBP,1.8567,-0.86%,0.0086,4.72,3.2,72101,33831,3809,53,11688,56061,45572,59923,26529,12178,"(CONTRACTS OF 62,500 POUNDS STERLING)"
06/07/2004,GBP,1.8408,-1.86%,0.0184,4.74,3.22,53855,23288,2211,52,7431,40914,30771,43177,23084,10678,"(CONTRACTS OF 62,500 POUNDS STERLING)"
29/06/2004,GBP,1.8072,0.76%,-0.0076,4.75,3.21,49713,16021,2137,52,11662,36388,27735,38577,21978,11136,"(CONTRACTS OF 62,500 POUNDS STERLING)"
22/06/2004,GBP,1.821,0.61%,-0.0061,4.72,3.26,47510,18393,2211,52,7529,32965,25974,35228,21536,12282,"(CONTRACTS OF 62,500 POUNDS STERLING)"
15/06/2004,GBP,1.8321,0.20%,-0.002,4.71,3.24,47098,18432,2224,52,7208,34860,25692,37136,21406,9962,"(CONTRACTS OF 62,500 POUNDS STERLING)"
08/06/2004,GBP,1.8357,0.23%,-0.0023,4.65,3.32,64694,19401,5924,584,22169,46436,42154,52944,22540,11750,"(CONTRACTS OF 62,500 POUNDS STERLING)"
01/06/2004,GBP,1.8399,-1.59%,0.0158,4.57,3.36,54636,16046,6013,184,15373,36429,31603,42626,23033,12010,"(CONTRACTS OF 62,500 POUNDS STERLING)"
25/05/2004,GBP,1.8111,-2.47%,0.0244,4.53,3.29,45355,9993,4091,76,17130,25995,27199,30162,18156,15193,"(CONTRACTS OF 62,500 POUNDS STERLING)"
18/05/2004,GBP,1.7675,-0.59%,0.0058,4.41,3.25,43218,7229,5616,113,19826,21237,27168,26966,16050,16252,"(CONTRACTS OF 62,500 POUNDS STERLING)"
11/05/2004,GBP,1.7572,2.27%,-0.023,4.37,3.23,48387,8702,5483,113,22215,24936,31030,30532,17357,17855,"(CONTRACTS OF 62,500 POUNDS STERLING)"
04/05/2004,GBP,1.7981,-0.34%,0.0034,4.33,3.26,46341,8405,3675,52,19753,27010,28210,30737,18131,15604,"(CONTRACTS OF 62,500 POUNDS STERLING)"
27/04/2004,GBP,1.792,-0.40%,0.004,4.32,3.25,42492,7965,4233,52,16797,23060,24814,27345,17678,15147,"(CONTRACTS OF 62,500 POUNDS STERLING)"
20/04/2004,GBP,1.7848,1.86%,-0.0188,4.29,3.21,41048,8083,2939,52,14613,24278,22748,27269,18300,13779,"(CONTRACTS OF 62,500 POUNDS STERLING)"
12/04/2004,GBP,1.8187,1.27%,-0.0128,4.28,3.24,45575,12752,2104,59,11950,31895,24761,34058,20814,11517,"(CONTRACTS OF 62,500 POUNDS STERLING)"
06/04/2004,GBP,1.8421,-0.89%,0.0088,4.31,3.28,45396,13475,2224,67,11928,32119,25470,34410,19926,10986,"(CONTRACTS OF 62,500 POUNDS STERLING)"
30/03/2004,GBP,1.8259,1.28%,-0.0128,4.27,3.27,39413,7141,1906,119,12915,26752,20175,28777,19238,10636,"(CONTRACTS OF 62,500 POUNDS STERLING)"
23/03/2004,GBP,1.8495,-2.10%,0.0208,4.22,3.21,43178,8351,2479,119,12927,29867,21397,32465,21781,10713,"(CONTRACTS OF 62,500 POUNDS STERLING)"
16/03/2004,GBP,1.8115,0.75%,-0.0075,4.17,3.15,37329,6579,2484,120,11652,23347,18351,25951,18978,11378,"(CONTRACTS OF 62,500 POUNDS STERLING)"
09/03/2004,GBP,1.8251,0.83%,-0.0083,4.18,3.19,73570,13288,2658,153,34791,56320,48232,59131,25338,14439,"(CONTRACTS OF 62,500 POUNDS STERLING)"
02/03/2004,GBP,1.8403,2.66%,-0.0269,4.17,3.16,63096,17565,3588,132,20850,46049,38547,49769,24549,13327,"(CONTRACTS OF 62,500 POUNDS STERLING)"
24/02/2004,GBP,1.8905,0.73%,-0.0073,4.08,3.07,69494,24415,3339,135,18548,53911,43098,57385,26396,12109,"(CONTRACTS OF 62,500 POUNDS STERLING)"
17/02/2004,GBP,1.9044,-1.81%,0.0179,4.04,3.04,70663,24010,3851,115,19037,52905,43162,56871,27501,13792,"(CONTRACTS OF 62,500 POUNDS STERLING)"
10/02/2004,GBP,1.8706,-1.78%,0.0176,4.07,3.03,67552,23388,3482,128,17264,53891,40780,57501,26772,10051,"(CONTRACTS OF 62,500 POUNDS STERLING)"
03/02/2004,GBP,1.8379,-0.58%,0.0058,4.06,3.02,66822,23623,2730,128,18480,53149,42231,56007,24591,10815,"(CONTRACTS OF 62,500 POUNDS STERLING)"
27/01/2004,GBP,1.8273,-0.41%,0.0041,4.03,3,63400,19967,2296,128,17691,51798,37786,54222,25614,9178,"(CONTRACTS OF 62,500 POUNDS STERLING)"
20/01/2004,GBP,1.8199,1.41%,-0.0142,3.96,2.92,61215,18594,2359,127,16278,48280,34999,50766,26216,10449,"(CONTRACTS OF 62,500 POUNDS STERLING)"
13/01/2004,GBP,1.846,-1.33%,0.0133,3.89,2.85,61829,17849,4159,127,15057,46286,33033,50572,28796,11257,"(CONTRACTS OF 62,500 POUNDS STERLING)"
06/01/2004,GBP,1.8217,-2.48%,0.0245,3.9,2.84,60146,22009,3959,127,10994,46039,33130,50125,27016,10021,"(CONTRACTS OF 62,500 POUNDS STERLING)"
30/12/2003,GBP,1.7776,-0.85%,0.0085,3.97,2.92,57504,22849,2893,19,7812,45951,30680,48863,26824,8641,"(CONTRACTS OF 62,500 POUNDS STERLING)"
22/12/2003,GBP,1.7626,-0.52%,0.0052,5.21,-0.09,57738,23165,2828,7,7361,44565,30533,47400,27205,10338,"(CONTRACTS OF 62,500 POUNDS STERLING)"
16/12/2003,GBP,1.7534,-0.36%,0.0036,3.94,2.85,67067,24923,2368,10,13454,53465,38387,55843,28680,11224,"(CONTRACTS OF 62,500 POUNDS STERLING)"
09/12/2003,GBP,1.7471,-0.99%,0.0099,3.89,2.82,93872,27080,2454,483,36080,75663,63643,78600,30229,15272,"(CONTRACTS OF 62,500 POUNDS STERLING)"
02/12/2003,GBP,1.7299,-1.89%,0.0187,3.9,2.83,74221,26628,3226,483,18747,59053,45858,62762,28363,11459,"(CONTRACTS OF 62,500 POUNDS STERLING)"
25/11/2003,GBP,1.6978,0.28%,-0.0028,3.9,2.86,67155,22356,3575,485,17347,52761,40188,56821,26967,10334,"(CONTRACTS OF 62,500 POUNDS STERLING)"
18/11/2003,GBP,1.7026,-2.28%,0.0225,3.9,2.83,68738,21525,2584,473,19079,54361,41077,57418,27661,11320,"(CONTRACTS OF 62,500 POUNDS STERLING)"
11/11/2003,GBP,1.6647,0.95%,-0.0095,3.85,2.79,63740,17150,2450,450,20937,50017,38537,52917,25203,10823,"(CONTRACTS OF 62,500 POUNDS STERLING)"
04/11/2003,GBP,1.6806,0.93%,-0.0094,3.87,2.82,66893,21766,2514,430,19565,53538,41761,56482,25132,10411,"(CONTRACTS OF 62,500 POUNDS STERLING)"
28/10/2003,GBP,1.6964,-1.30%,0.0129,3.83,2.77,65065,23023,3357,414,14919,49775,38356,53546,26709,11519,"(CONTRACTS OF 62,500 POUNDS STERLING)"
21/10/2003,GBP,1.6747,-0.17%,0.0017,3.67,2.62,53768,15687,3121,0,12294,40038,27981,43159,25787,10609,"(CONTRACTS OF 62,500 POUNDS STERLING)"
14/10/2003,GBP,1.6719,-0.52%,0.0052,3.68,2.64,53815,15428,4728,1,13478,39245,28907,43974,24908,9841,"(CONTRACTS OF 62,500 POUNDS STERLING)"
07/10/2003,GBP,1.6632,-0.14%,0.0014,3.62,2.59,51131,15295,3678,0,13401,37651,28696,41329,22435,9802,"(CONTRACTS OF 62,500 POUNDS STERLING)"
30/09/2003,GBP,1.6609,-0.63%,0.0063,3.59,2.56,48321,12371,2448,0,13845,36802,26216,39250,22105,9071,"(CONTRACTS OF 62,500 POUNDS STERLING)"
23/09/2003,GBP,1.6505,-3.94%,0.0386,3.58,2.55,36402,12753,2707,0,5716,24115,18469,26822,17933,9580,"(CONTRACTS OF 62,500 POUNDS STERLING)"
16/09/2003,GBP,1.588,0.20%,-0.002,3.58,2.55,26786,4540,3019,0,8509,14517,13049,17536,13737,9250,"(CONTRACTS OF 62,500 POUNDS STERLING)"
09/09/2003,GBP,1.5912,-1.54%,0.0153,3.6,2.56,44767,4125,4739,0,22711,23970,26836,28709,17931,16058,"(CONTRACTS OF 62,500 POUNDS STERLING)"
02/09/2003,GBP,1.567,0.11%,-0.0011,3.56,2.51,42438,4717,7042,139,20031,19627,24887,26808,17551,15630,"(CONTRACTS OF 62,500 POUNDS STERLING)"
26/08/2003,GBP,1.5688,1.20%,-0.0121,3.45,2.44,49139,3953,6136,615,28725,29067,33293,35818,15846,13321,"(CONTRACTS OF 62,500 POUNDS STERLING)"
19/08/2003,GBP,1.5879,0.90%,-0.0091,3.39,2.37,47837,3143,6746,570,28279,29372,31992,36688,15845,11149,"(CONTRACTS OF 62,500 POUNDS STERLING)"
12/08/2003,GBP,1.6024,0.79%,-0.008,3.4,2.37,44939,3107,2526,555,25545,31450,29207,34531,15732,10408,"(CONTRACTS OF 62,500 POUNDS STERLING)"
05/08/2003,GBP,1.6152,0.54%,-0.0054,3.35,2.33,45719,3660,3959,539,26475,29344,30674,33842,15045,11877,"(CONTRACTS OF 62,500 POUNDS STERLING)"
29/07/2003,GBP,1.6239,-1.75%,0.0173,3.35,2.32,44811,3595,5281,538,26412,27491,30545,33310,14266,11501,"(CONTRACTS OF 62,500 POUNDS STERLING)"
22/07/2003,GBP,1.596,-0.32%,0.0032,3.29,2.28,36574,3487,4142,559,15911,20672,19957,25373,16617,11201,"(CONTRACTS OF 62,500 POUNDS STERLING)"
15/07/2003,GBP,1.5909,2.70%,-0.0274,3.31,2.31,39893,5501,2999,606,14548,24862,20655,28467,19238,11426,"(CONTRACTS OF 62,500 POUNDS STERLING)"
08/07/2003,GBP,1.6351,1.65%,-0.0166,3.47,2.46,45011,14414,4460,626,8220,28394,23260,33480,21751,11531,"(CONTRACTS OF 62,500 POUNDS STERLING)"
01/07/2003,GBP,1.6625,0.02%,-0.0002,3.48,2.47,47221,18710,2272,687,4912,34494,24309,37453,22912,9768,"(CONTRACTS OF 62,500 POUNDS STERLING)"
24/06/2003,GBP,1.6628,1.33%,-0.0134,3.5,2.62,45976,18775,1558,662,2843,33287,22280,35507,23696,10469,"(CONTRACTS OF 62,500 POUNDS STERLING)"
17/06/2003,GBP,1.6852,-2.05%,0.0203,3.52,2.59,46234,19709,2261,666,1174,32663,21549,35590,24685,10644,"(CONTRACTS OF 62,500 POUNDS STERLING)"
10/06/2003,GBP,1.6514,-1.41%,0.014,3.52,2.48,59050,20014,1970,626,10302,42723,30942,45319,28108,13731,"(CONTRACTS OF 62,500 POUNDS STERLING)"
03/06/2003,GBP,1.6285,0.59%,-0.0059,3.48,2.31,48222,17567,1531,657,5593,34926,23817,37114,24405,11108,"(CONTRACTS OF 62,500 POUNDS STERLING)"
27/05/2003,GBP,1.6381,0.15%,-0.0015,3.55,2.35,39958,10497,2765,605,6930,25200,18032,28570,21926,11388,"(CONTRACTS OF 62,500 POUNDS STERLING)"
20/05/2003,GBP,1.6406,-1.99%,0.0197,3.5,2.38,37761,9042,2156,591,7571,24654,17204,27401,20557,10360,"(CONTRACTS OF 62,500 POUNDS STERLING)"
13/05/2003,GBP,1.6086,0.43%,-0.0043,3.53,2.35,32959,7470,3376,614,6319,19154,14403,23144,18556,9815,"(CONTRACTS OF 62,500 POUNDS STERLING)"
06/05/2003,GBP,1.6155,-1.32%,0.0131,3.52,2.38,31088,9393,4465,514,4309,17404,14216,22383,16872,8705,"(CONTRACTS OF 62,500 POUNDS STERLING)"
29/04/2003,GBP,1.5944,-1.08%,0.0107,3.53,2.31,27870,2135,4676,525,9472,13505,12132,18706,15738,9164,"(CONTRACTS OF 62,500 POUNDS STERLING)"
22/04/2003,GBP,1.5774,-0.47%,0.0047,3.53,2.32,25201,2053,4681,504,11426,8411,13983,13596,11218,11605,"(CONTRACTS OF 62,500 POUNDS STERLING)"
15/04/2003,GBP,1.57,-1.03%,0.0102,3.54,2.31,23221,993,4064,78,10628,5895,11699,10037,11522,13184,"(CONTRACTS OF 62,500 POUNDS STERLING)"
08/04/2003,GBP,1.554,1.51%,-0.0152,3.5,2.34,25980,973,4835,0,13736,7072,14709,11907,11271,14073,"(CONTRACTS OF 62,500 POUNDS STERLING)"
01/04/2003,GBP,1.5778,-0.34%,0.0034,3.5,2.36,21711,563,3101,10,8348,6215,8921,9326,12790,12385,"(CONTRACTS OF 62,500 POUNDS STERLING)"
25/03/2003,GBP,1.5725,-0.41%,0.0041,3.58,2.38,20470,700,3300,32,7550,5801,8282,9133,12188,11337,"(CONTRACTS OF 62,500 POUNDS STERLING)"
18/03/2003,GBP,1.5661,2.54%,-0.0257,3.54,2.37,21258,592,4968,20,8503,4584,9115,9572,12143,11686,"(CONTRACTS OF 62,500 POUNDS STERLING)"
11/03/2003,GBP,1.6069,-1.62%,0.0161,3.56,2.45,34292,4123,2685,0,14046,19809,18169,22494,16123,11798,"(CONTRACTS OF 62,500 POUNDS STERLING)"
04/03/2003,GBP,1.5813,-0.50%,0.0049,3.57,2.34,29889,3496,3684,666,12491,12218,16653,16568,13236,13321,"(CONTRACTS OF 62,500 POUNDS STERLING)"
25/02/2003,GBP,1.5735,1.05%,-0.0106,3.55,2.32,28528,3807,4717,121,9994,11917,13922,16755,14606,11773,"(CONTRACTS OF 62,500 POUNDS STERLING)"
18/02/2003,GBP,1.5902,1.74%,-0.0175,3.61,2.36,33382,6298,5922,140,7184,16244,13622,22306,19760,11076,"(CONTRACTS OF 62,500 POUNDS STERLING)"
11/02/2003,GBP,1.6183,1.87%,-0.0189,3.61,2.35,35251,10006,5014,400,3410,18703,13816,24117,21435,11134,"(CONTRACTS OF 62,500 POUNDS STERLING)"
04/02/2003,GBP,1.6492,-0.53%,0.0053,3.84,2.6,37750,13415,4433,220,1954,22931,15589,27584,22161,10166,"(CONTRACTS OF 62,500 POUNDS STERLING)"
28/01/2003,GBP,1.6405,-1.43%,0.0142,3.78,2.54,37111,13369,4065,343,1474,22765,15186,27173,21925,9938,"(CONTRACTS OF 62,500 POUNDS STERLING)"
21/01/2003,GBP,1.6173,-0.77%,0.0077,3.87,2.63,37884,14909,3618,104,2153,25470,17166,29192,20718,8692,"(CONTRACTS OF 62,500 POUNDS STERLING)"
14/01/2003,GBP,1.6049,-0.04%,0.0004,3.9,2.62,37182,13773,3608,115,1050,24151,14938,27874,22244,9308,"(CONTRACTS OF 62,500 POUNDS STERLING)"
07/01/2003,GBP,1.6043,0.42%,-0.0042,3.89,2.6,36924,13444,4630,244,1189,23102,14877,27976,22047,8948,"(CONTRACTS OF 62,500 POUNDS STERLING)"
31/12/2002,GBP,1.611,-1.11%,0.011,3.89,2.61,34823,11957,3587,69,1089,22956,13115,26612,21708,8211,"(CONTRACTS OF 62,500 POUNDS STERLING)"
23/12/2002,GBP,1.5933,0.34%,-0.0034,3.98,2.6,34020,10488,3587,69,1565,21971,12122,25627,21898,8393,"(CONTRACTS OF 62,500 POUNDS STERLING)"
17/12/2002,GBP,1.5988,-1.80%,0.0178,3.89,2.55,32946,11344,3587,68,1468,21878,12880,25533,20066,7413,"(CONTRACTS OF 62,500 POUNDS STERLING)"
10/12/2002,GBP,1.5706,-0.07%,0.0007,3.9,2.56,40447,7079,3537,0,13696,25438,20775,28975,19672,11472,"(CONTRACTS OF 62,500 POUNDS STERLING)"
03/12/2002,GBP,1.5695,-1.13%,0.0112,3.91,2.56,33681,5052,4312,0,11921,19534,16973,23846,16708,9835,"(CONTRACTS OF 62,500 POUNDS STERLING)"
26/11/2002,GBP,1.552,1.80%,-0.0182,3.89,2.54,38687,11414,4668,158,7809,22834,19381,27660,19306,11027,"(CONTRACTS OF 62,500 POUNDS STERLING)"
19/11/2002,GBP,1.5805,0.57%,-0.0057,3.88,2.54,43939,17779,4404,39,3740,30361,21558,34804,22381,9135,"(CONTRACTS OF 62,500 POUNDS STERLING)"
12/11/2002,GBP,1.5895,-1.73%,0.0171,3.86,2.52,45933,19263,3944,0,3766,32510,23029,36454,22904,9479,"(CONTRACTS OF 62,500 POUNDS STERLING)"
05/11/2002,GBP,1.5625,-0.39%,0.0038,3.82,2.3,37029,14957,4994,158,3148,24187,18263,29339,18766,7690,"(CONTRACTS OF 62,500 POUNDS STERLING)"
29/10/2002,GBP,1.5565,-0.71%,0.0071,3.86,2.19,32297,11193,3516,0,2249,20108,13442,23624,18855,8673,"(CONTRACTS OF 62,500 POUNDS STERLING)"
22/10/2002,GBP,1.5455,0.48%,-0.0048,3.88,2.15,26456,4835,4568,41,5157,12503,10033,17112,16423,9344,"(CONTRACTS OF 62,500 POUNDS STERLING)"
15/10/2002,GBP,1.5529,0.00%,0,3.86,2.16,28327,6431,4146,10,4251,13304,10692,17460,17635,10867,"(CONTRACTS OF 62,500 POUNDS STERLING)"
08/10/2002,GBP,1.5529,0.84%,-0.0084,3.82,2.17,30743,5780,6935,0,5919,13970,11699,20905,19044,9838,"(CONTRACTS OF 62,500 POUNDS STERLING)"
01/10/2002,GBP,1.566,-0.48%,0.0048,3.8,2.12,28653,5396,5780,10,2380,13558,7786,19348,20867,9305,"(CONTRACTS OF 62,500 POUNDS STERLING)"
24/09/2002,GBP,1.5585,-1.10%,0.011,3.84,2.13,23398,3382,5062,0,3660,10931,7042,15993,16356,7405,"(CONTRACTS OF 62,500 POUNDS STERLING)"
17/09/2002,GBP,1.5415,0.86%,-0.0086,3.89,2.16,22269,2739,5162,0,3751,8685,6490,13847,15779,8422,"(CONTRACTS OF 62,500 POUNDS STERLING)"
10/09/2002,GBP,1.5548,0.67%,-0.0067,3.93,2.2,39093,5795,3772,956,14276,25891,21027,30619,18066,8474,"(CONTRACTS OF 62,500 POUNDS STERLING)"
03/09/2002,GBP,1.5653,-2.05%,0.0203,3.88,2.15,33512,5732,2861,11,10847,22082,16590,24954,16922,8558,"(CONTRACTS OF 62,500 POUNDS STERLING)"
27/08/2002,GBP,1.5339,-0.37%,0.0037,3.91,2.18,32571,6160,3597,11,11094,20012,17265,23620,15306,8951,"(CONTRACTS OF 62,500 POUNDS STERLING)"
20/08/2002,GBP,1.5283,0.59%,-0.0059,3.9,2.21,30012,2805,3982,28,13326,16938,16159,20948,13853,9064,"(CONTRACTS OF 62,500 POUNDS STERLING)"
13/08/2002,GBP,1.5374,0.01%,-0.0001,3.87,2.24,28961,3798,2767,28,10835,18422,14661,21217,14300,7744,"(CONTRACTS OF 62,500 POUNDS STERLING)"
06/08/2002,GBP,1.5375,2.23%,-0.0226,3.89,2.18,33265,5963,3431,32,10708,21144,16703,24607,16562,8658,"(CONTRACTS OF 62,500 POUNDS STERLING)"
30/07/2002,GBP,1.5726,-0.65%,0.0065,3.91,2.17,35941,6234,4720,32,11817,21781,18083,26533,17858,9408,"(CONTRACTS OF 62,500 POUNDS STERLING)"
23/07/2002,GBP,1.5624,0.81%,-0.0081,3.9,2.19,35862,5186,5019,32,11894,21202,17112,26253,18750,9609,"(CONTRACTS OF 62,500 POUNDS STERLING)"
16/07/2002,GBP,1.5751,-1.74%,0.0173,3.93,2.16,37231,5382,5637,11,12261,20997,17654,26645,19577,10586,"(CONTRACTS OF 62,500 POUNDS STERLING)"
09/07/2002,GBP,1.5481,-0.82%,0.0082,3.93,2.17,39998,9072,7156,87,11682,24005,20841,31248,19157,8750,"(CONTRACTS OF 62,500 POUNDS STERLING)"
02/07/2002,GBP,1.5355,-1.80%,0.0179,4.04,2.27,40504,9892,7663,84,10734,22631,20710,30378,19794,10126,"(CONTRACTS OF 62,500 POUNDS STERLING)"
25/06/2002,GBP,1.5083,-1.17%,0.0117,4.03,2.25,43586,13284,8044,9,8937,26924,22230,34977,21356,8609,"(CONTRACTS OF 62,500 POUNDS STERLING)"
18/06/2002,GBP,1.4908,-1.33%,0.0132,4.07,2.29,44886,14829,8986,0,7764,28027,22593,37013,22293,7873,"(CONTRACTS OF 62,500 POUNDS STERLING)"
11/06/2002,GBP,1.4712,-0.88%,0.0088,4.06,2.28,55572,16657,6829,363,13980,39106,31000,46298,24572,9274,"(CONTRACTS OF 62,500 POUNDS STERLING)"
04/06/2002,GBP,1.4583,0.02%,-0.0002,4.09,2.3,43285,9819,6969,12,12752,28526,22583,35507,20702,7778,"(CONTRACTS OF 62,500 POUNDS STERLING)"
28/05/2002,GBP,1.4586,0.08%,-0.0008,4.05,2.25,46069,11317,6671,1,11965,31983,23283,38655,22786,7414,"(CONTRACTS OF 62,500 POUNDS STERLING)"
21/05/2002,GBP,1.4597,-0.66%,0.0066,4.03,2.23,45036,12071,6832,1,12199,30169,24271,37002,20765,8034,"(CONTRACTS OF 62,500 POUNDS STERLING)"
14/05/2002,GBP,1.4501,1.17%,-0.0118,4.05,2.24,44927,13376,8983,120,12687,26625,26183,35728,18744,9199,"(CONTRACTS OF 62,500 POUNDS STERLING)"
07/05/2002,GBP,1.4673,-0.71%,0.007,4.05,2.29,50156,19501,7831,241,9491,34045,29233,42117,20923,8039,"(CONTRACTS OF 62,500 POUNDS STERLING)"
30/04/2002,GBP,1.457,-0.71%,0.0071,4.02,2.21,45691,17061,6503,241,9276,31561,26578,38305,19113,7386,"(CONTRACTS OF 62,500 POUNDS STERLING)"
23/04/2002,GBP,1.4467,-0.46%,0.0046,4.05,2.22,42976,13688,5007,240,8948,28921,22876,34168,20100,8808,"(CONTRACTS OF 62,500 POUNDS STERLING)"
16/04/2002,GBP,1.4401,-0.23%,0.0023,4.08,2.22,37817,8350,5913,240,10757,23873,19347,30026,18470,7791,"(CONTRACTS OF 62,500 POUNDS STERLING)"
09/04/2002,GBP,1.4368,-0.10%,0.001,4.07,2.2,34199,5868,5624,0,10876,21501,16744,27125,17455,7074,"(CONTRACTS OF 62,500 POUNDS STERLING)"
02/04/2002,GBP,1.4353,-0.60%,0.006,4.12,2.2,38169,10649,6047,0,8601,23027,19250,29074,18919,9095,"(CONTRACTS OF 62,500 POUNDS STERLING)"
26/03/2002,GBP,1.4267,-0.18%,0.0018,4.1,2.16,29410,6723,7578,0,10704,12077,17427,19655,11983,9755,"(CONTRACTS OF 62,500 POUNDS STERLING)"
19/03/2002,GBP,1.4241,-0.66%,0.0066,4.03,2.09,27150,2360,9051,0,15322,6470,17682,15521,9468,11629,"(CONTRACTS OF 62,500 POUNDS STERLING)"
12/03/2002,GBP,1.4148,0.69%,-0.0069,4.01,2.11,39898,2112,12235,114,25956,10782,28182,23131,11716,16767,"(CONTRACTS OF 62,500 POUNDS STERLING)"
05/03/2002,GBP,1.4246,-0.61%,0.0061,3.97,2.15,27814,3367,6963,0,14664,7007,18031,13970,9783,13844,"(CONTRACTS OF 62,500 POUNDS STERLING)"
26/02/2002,GBP,1.416,1.05%,-0.0105,3.96,2.15,33026,3560,9774,0,19107,8157,22667,17931,10359,15095,"(CONTRACTS OF 62,500 POUNDS STERLING)"
19/02/2002,GBP,1.431,0.22%,-0.0022,3.97,2.16,26728,1597,7192,0,12892,7474,14489,14666,12239,12062,"(CONTRACTS OF 62,500 POUNDS STERLING)"
12/02/2002,GBP,1.4342,-1.36%,0.0135,3.93,2.13,31419,3751,9149,0,17163,8244,20914,17393,10505,14026,"(CONTRACTS OF 62,500 POUNDS STERLING)"
05/02/2002,GBP,1.415,-0.11%,0.0011,3.92,2.11,33289,545,11409,2,23182,3422,23729,14833,9560,18456,"(CONTRACTS OF 62,500 POUNDS STERLING)"
29/01/2002,GBP,1.4135,1.09%,-0.011,3.95,2.18,33552,992,12934,2,21977,4057,22971,16993,10581,16559,"(CONTRACTS OF 62,500 POUNDS STERLING)"
22/01/2002,GBP,1.4291,0.72%,-0.0073,3.94,2.22,25242,1725,4814,1,12999,7051,14725,11866,10517,13376,"(CONTRACTS OF 62,500 POUNDS STERLING)"
15/01/2002,GBP,1.4395,-0.03%,0.0003,3.96,2.33,25096,900,5417,2,12134,9795,13036,15214,12060,9882,"(CONTRACTS OF 62,500 POUNDS STERLING)"
08/01/2002,GBP,1.439,0.74%,-0.0075,3.99,2.24,24447,966,4376,2,10330,10923,11298,15301,13149,9146,"(CONTRACTS OF 62,500 POUNDS STERLING)"
28/12/2001,GBP,1.4498,-0.84%,0.0084,3.94,2.18,22515,647,3132,2,10324,12137,10973,15271,11542,7244,"(CONTRACTS OF 62,500 POUNDS STERLING)"
21/12/2001,GBP,1.4377,1.31%,-0.0132,3.98,2.11,22919,2670,4298,20,9564,10195,12254,14513,10665,8406,"(CONTRACTS OF 62,500 POUNDS STERLING)"
18/12/2001,GBP,1.4568,-1.23%,0.0122,3.96,2.1,23677,4889,3147,0,6507,12136,11396,15283,12281,8394,"(CONTRACTS OF 62,500 POUNDS STERLING)"
11/12/2001,GBP,1.4391,-1.25%,0.0124,3.93,2.14,44312,2417,4877,0,30037,23481,32454,28358,11858,15954,"(CONTRACTS OF 62,500 POUNDS STERLING)"
04/12/2001,GBP,1.4214,-0.45%,0.0044,3.91,2.1,42861,1888,10836,0,32555,16822,34443,27658,8418,15203,"(CONTRACTS OF 62,500 POUNDS STERLING)"
27/11/2001,GBP,1.4151,0.29%,-0.0029,3.9,1.89,43792,1801,10279,20,31322,16940,33143,27239,10649,16553,"(CONTRACTS OF 62,500 POUNDS STERLING)"
20/11/2001,GBP,1.4192,1.52%,-0.0153,3.82,1.78,43540,3162,9220,19,29157,17475,32338,26714,11202,16826,"(CONTRACTS OF 62,500 POUNDS STERLING)"
13/11/2001,GBP,1.4411,1.08%,-0.0109,3.83,1.93,38885,4989,3234,0,20289,25260,25278,28494,13607,10391,"(CONTRACTS OF 62,500 POUNDS STERLING)"
06/11/2001,GBP,1.4569,-0.41%,0.0041,4.01,2.07,37327,6416,4366,0,17059,25032,23475,29398,13852,7929,"(CONTRACTS OF 62,500 POUNDS STERLING)"
30/10/2001,GBP,1.4509,-1.78%,0.0177,4,1.94,38163,6313,5414,0,20535,22865,26848,28279,11315,9884,"(CONTRACTS OF 62,500 POUNDS STERLING)"
23/10/2001,GBP,1.4255,1.59%,-0.0161,4.32,2.04,39343,4946,6225,0,21190,20710,26136,26935,13207,12408,"(CONTRACTS OF 62,500 POUNDS STERLING)"
16/10/2001,GBP,1.4486,0.62%,-0.0063,4.36,2.02,37905,9690,4904,4,13434,23011,23128,27919,14777,9986,"(CONTRACTS OF 62,500 POUNDS STERLING)"
09/10/2001,GBP,1.4577,0.78%,-0.0078,4.34,2,40137,13342,5054,4,8969,26530,22315,31588,17822,8549,"(CONTRACTS OF 62,500 POUNDS STERLING)"
02/10/2001,GBP,1.4691,0.07%,-0.0007,4.4,1.96,40185,13436,4242,4,9195,26321,22635,30567,17550,9618,"(CONTRACTS OF 62,500 POUNDS STERLING)"
25/09/2001,GBP,1.4701,-0.16%,0.0016,4.38,1.96,40103,13092,3786,4,7926,28635,21022,32425,19081,7678,"(CONTRACTS OF 62,500 POUNDS STERLING)"
18/09/2001,GBP,1.4678,0.60%,-0.006,4.53,1.71,39768,13239,3070,0,9291,29226,22530,32296,17238,7472,"(CONTRACTS OF 62,500 POUNDS STERLING)"
10/09/2001,GBP,1.4767,-2.22%,0.022,4.67,1.42,63015,17074,4649,0,22810,44934,39884,49583,23131,13432,"(CONTRACTS OF 62,500 POUNDS STERLING)"
04/09/2001,GBP,1.4446,0.56%,-0.0057,4.79,1.37,48467,16192,4146,22,12737,31620,28951,35788,19516,12679,"(CONTRACTS OF 62,500 POUNDS STERLING)"
28/08/2001,GBP,1.4528,0.12%,-0.0012,4.84,1.48,50269,18852,4059,8,11984,36358,30844,40425,19425,9844,"(CONTRACTS OF 62,500 POUNDS STERLING)"
21/08/2001,GBP,1.4545,-1.81%,0.018,4.84,1.41,45476,15386,4586,8,20898,40374,36292,44968,9184,508,"(CONTRACTS OF 62,500 POUNDS STERLING)"
14/08/2001,GBP,1.4286,-0.92%,0.0091,4.78,1.35,36855,6161,4953,0,25961,30371,32122,35324,4733,1531,"(CONTRACTS OF 62,500 POUNDS STERLING)"
07/08/2001,GBP,1.4156,0.63%,-0.0063,4.88,1.31,33927,2643,5780,0,20402,14148,23045,19928,10882,13999,"(CONTRACTS OF 62,500 POUNDS STERLING)"
31/07/2001,GBP,1.4246,-0.18%,0.0018,5.03,1.42,31886,3476,5488,0,16284,15296,19760,20784,12126,11102,"(CONTRACTS OF 62,500 POUNDS STERLING)"
24/07/2001,GBP,1.4221,-1.46%,0.0145,5.13,1.51,31979,3602,5322,0,15993,15096,19595,20418,12384,11561,"(CONTRACTS OF 62,500 POUNDS STERLING)"
17/07/2001,GBP,1.4016,0.67%,-0.0067,5.06,1.43,33246,2164,9846,0,22495,5976,24659,15822,8587,17424,"(CONTRACTS OF 62,500 POUNDS STERLING)"
10/07/2001,GBP,1.411,-0.28%,0.0028,5.09,1.4,34163,1781,8598,0,23386,8154,25167,16752,8996,17411,"(CONTRACTS OF 62,500 POUNDS STERLING)"
03/07/2001,GBP,1.407,0.59%,-0.006,5.12,1.3,35912,844,9409,0,26219,7346,27063,16755,8849,19157,"(CONTRACTS OF 62,500 POUNDS STERLING)"
26/06/2001,GBP,1.4154,-1.01%,0.01,5.12,1.46,34659,1486,10437,0,24143,6343,25629,16780,9030,17879,"(CONTRACTS OF 62,500 POUNDS STERLING)"
19/06/2001,GBP,1.4013,-1.99%,0.0197,5.14,1.5,39946,1397,14748,0,31618,4858,33015,19606,6931,20340,"(CONTRACTS OF 62,500 POUNDS STERLING)"
12/06/2001,GBP,1.3739,2.79%,-0.0283,5.16,1.35,61357,3767,16168,338,45011,23163,49116,39669,12241,21688,"(CONTRACTS OF 62,500 POUNDS STERLING)"
05/06/2001,GBP,1.4133,0.68%,-0.0068,5.11,1.3,47003,2002,14243,3,38348,14239,40353,28485,6650,18518,"(CONTRACTS OF 62,500 POUNDS STERLING)"
29/05/2001,GBP,1.423,0.30%,-0.003,5.09,1.19,44794,2039,11897,0,35867,13884,37906,25781,6888,19013,"(CONTRACTS OF 62,500 POUNDS STERLING)"
22/05/2001,GBP,1.4273,-0.18%,0.0018,5.05,1.14,40620,1740,9764,7,32606,13921,34353,23692,6267,16928,"(CONTRACTS OF 62,500 POUNDS STERLING)"
15/05/2001,GBP,1.4247,0.10%,-0.001,5.09,1.15,41505,1052,11366,0,32551,12211,33603,23577,7902,17928,"(CONTRACTS OF 62,500 POUNDS STERLING)"
08/05/2001,GBP,1.4261,0.56%,-0.0057,5.02,1.08,39216,1866,11388,0,29731,10981,31597,22369,7619,16847,"(CONTRACTS OF 62,500 POUNDS STERLING)"
01/05/2001,GBP,1.4342,-0.01%,0.0001,5.09,0.91,34963,1822,7414,0,26570,12659,28392,20073,6571,14890,"(CONTRACTS OF 62,500 POUNDS STERLING)"
24/04/2001,GBP,1.434,-0.13%,0.0013,5.23,0.99,33311,1966,6979,0,24181,13139,26147,20118,7164,13193,"(CONTRACTS OF 62,500 POUNDS STERLING)"
17/04/2001,GBP,1.4322,-0.03%,0.0003,5.31,0.65,33572,1506,8479,0,27344,11266,28850,19745,4722,13827,"(CONTRACTS OF 62,500 POUNDS STERLING)"
10/04/2001,GBP,1.4318,0.06%,-0.0006,5.22,0.54,32735,1633,7212,0,25000,10400,26633,17612,6102,15123,"(CONTRACTS OF 62,500 POUNDS STERLING)"
03/04/2001,GBP,1.4327,-0.01%,0.0001,5.36,0.58,37712,1815,10279,0,28726,10436,30541,20715,7171,16997,"(CONTRACTS OF 62,500 POUNDS STERLING)"
27/03/2001,GBP,1.4326,0.20%,-0.002,5.375,0.58,34343,1069,9371,0,24855,10014,25924,19385,8419,14958,"(CONTRACTS OF 62,500 POUNDS STERLING)"
20/03/2001,GBP,1.4354,0.96%,-0.0096,5.39,0.61,29527,1004,6110,0,20006,9919,21010,16029,8517,13498,"(CONTRACTS OF 62,500 POUNDS STERLING)"
13/03/2001,GBP,1.4493,1.19%,-0.012,5.44,0.57,41230,5980,4982,0,24513,25117,30493,30099,10737,11131,"(CONTRACTS OF 62,500 POUNDS STERLING)"
06/03/2001,GBP,1.4668,-1.68%,0.0167,5.55,0.53,37437,3435,3392,0,22347,21968,25782,25360,11655,12077,"(CONTRACTS OF 62,500 POUNDS STERLING)"
27/02/2001,GBP,1.4425,0.31%,-0.0031,5.38,0.43,31691,2104,4842,0,20777,11432,22881,16274,8810,15417,"(CONTRACTS OF 62,500 POUNDS STERLING)"
20/02/2001,GBP,1.447,0.36%,-0.0036,5.65,0.35,32335,2116,5066,0,21148,12196,23264,17262,9071,15073,"(CONTRACTS OF 62,500 POUNDS STERLING)"
13/02/2001,GBP,1.4522,0.50%,-0.005,5.64,0.33,30561,2556,4257,0,19930,13562,22486,17819,8075,12742,"(CONTRACTS OF 62,500 POUNDS STERLING)"
06/02/2001,GBP,1.4595,0.18%,-0.0018,5.65,0.3,28738,2750,1748,0,15602,17184,18352,18932,10386,9806,"(CONTRACTS OF 62,500 POUNDS STERLING)"
30/01/2001,GBP,1.4622,0.53%,-0.0053,5.66,0.24,27837,2130,772,0,13929,18207,16059,18979,11778,8858,"(CONTRACTS OF 62,500 POUNDS STERLING)"
23/01/2001,GBP,1.47,0.11%,-0.0011,5.66,0.15,28835,3091,1223,0,13407,19705,16498,20928,12337,7907,"(CONTRACTS OF 62,500 POUNDS STERLING)"
16/01/2001,GBP,1.4716,1.25%,-0.0126,5.7,0.01,29854,3463,1463,0,13924,20735,17387,22198,12467,7656,"(CONTRACTS OF 62,500 POUNDS STERLING)"
09/01/2001,GBP,1.4903,0.65%,-0.0065,5.72,0.21,29253,3410,772,0,12727,21120,16137,21892,13116,7361,"(CONTRACTS OF 62,500 POUNDS STERLING)"
02/01/2001,GBP,1.5,-1.16%,0.0115,5.6,-0.57,27079,3722,1885,0,11354,17452,15076,19337,12003,7742,"(CONTRACTS OF 62,500 POUNDS STERLING)"
26/12/2000,GBP,1.4828,-0.95%,0.0094,5.75,-0.56,23181,1518,1906,0,11173,11976,12691,13882,10490,9299,"(CONTRACTS OF 62,500 POUNDS STERLING)"
19/12/2000,GBP,1.4689,-1.39%,0.0138,5.9,-0.51,23226,920,2538,0,13142,9914,14062,12452,9164,10774,"(CONTRACTS OF 62,500 POUNDS STERLING)"
12/12/2000,GBP,1.4488,-1.16%,0.0115,5.81,-0.66,38716,667,2856,0,28539,21153,29206,24009,9510,14707,"(CONTRACTS OF 62,500 POUNDS STERLING)"
05/12/2000,GBP,1.4322,-1.16%,0.0115,5.82,-0.72,40519,552,5901,0,30799,19379,31351,25280,9168,15239,"(CONTRACTS OF 62,500 POUNDS STERLING)"
28/11/2000,GBP,1.4158,0.13%,-0.0013,5.83,-0.85,37298,610,7579,0,27256,11214,27866,18793,9432,18505,"(CONTRACTS OF 62,500 POUNDS STERLING)"
21/11/2000,GBP,1.4176,0.94%,-0.0094,5.96,-0.7,36018,594,6418,0,27864,12215,28458,18633,7560,17385,"(CONTRACTS OF 62,500 POUNDS STERLING)"
14/11/2000,GBP,1.431,0.24%,-0.0024,6,-0.65,33617,412,4754,0,25740,12921,26152,17675,7465,15942,"(CONTRACTS OF 62,500 POUNDS STERLING)"
07/11/2000,GBP,1.4345,0.94%,-0.0094,5.98,-0.68,34188,1166,4934,0,25748,12554,26914,17488,7274,16700,"(CONTRACTS OF 62,500 POUNDS STERLING)"
31/10/2000,GBP,1.4481,0.10%,-0.001,5.98,-0.67,31177,724,4149,0,22383,13517,23107,17666,8070,13511,"(CONTRACTS OF 62,500 POUNDS STERLING)"
24/10/2000,GBP,1.4496,0.02%,-0.0002,6,-0.64,30852,71,4284,0,22989,12705,23060,16989,7792,13863,"(CONTRACTS OF 62,500 POUNDS STERLING)"
17/10/2000,GBP,1.4499,0.33%,-0.0033,5.96,-0.65,31982,638,5369,13,23233,12195,23884,17577,8098,14405,"(CONTRACTS OF 62,500 POUNDS STERLING)"
10/10/2000,GBP,1.4547,0.29%,-0.003,6.08,-0.58,30327,99,4160,0,20677,12203,20776,16363,9551,13964,"(CONTRACTS OF 62,500 POUNDS STERLING)"
03/10/2000,GBP,1.459,0.30%,-0.003,6.06,-0.65,30294,46,5317,10,21478,11111,21534,16438,8760,13856,"(CONTRACTS OF 62,500 POUNDS STERLING)"
26/09/2000,GBP,1.4634,-3.85%,0.0377,6.05,-0.5,32381,36,6943,1,24311,10998,24348,17942,8033,14439,"(CONTRACTS OF 62,500 POUNDS STERLING)"
19/09/2000,GBP,1.4092,-0.16%,0.0016,6.04,-0.54,37690,4,15026,0,27469,3955,27473,18981,10217,18709,"(CONTRACTS OF 62,500 POUNDS STERLING)"
12/09/2000,GBP,1.4069,3.27%,-0.0332,6.12,-0.48,54969,470,15255,20,38430,13891,38920,29166,16049,25803,"(CONTRACTS OF 62,500 POUNDS STERLING)"
05/09/2000,GBP,1.4544,0.10%,-0.001,6.13,-0.46,45161,807,16981,0,34941,7528,35748,24509,9413,20652,"(CONTRACTS OF 62,500 POUNDS STERLING)"
29/08/2000,GBP,1.4558,1.77%,-0.0179,6.12,-0.46,45752,0,16574,0,35583,8752,35583,25326,10169,20426,"(CONTRACTS OF 62,500 POUNDS STERLING)"
22/08/2000,GBP,1.4821,1.42%,-0.0143,6.09,-0.51,41087,401,15086,0,33424,8528,33825,23614,7262,17473,"(CONTRACTS OF 62,500 POUNDS STERLING)"
15/08/2000,GBP,1.5035,0.09%,-0.0009,6.1,-0.46,30511,689,5913,0,23310,8869,23999,14782,6512,15729,"(CONTRACTS OF 62,500 POUNDS STERLING)"
08/08/2000,GBP,1.5049,-0.88%,0.0088,6.09,-0.48,31666,1068,6120,0,23548,9857,24616,15977,7050,15689,"(CONTRACTS OF 62,500 POUNDS STERLING)"
01/08/2000,GBP,1.4917,1.59%,-0.016,6.12,-0.51,31895,1458,5087,0,22845,10578,24303,15665,7592,16230,"(CONTRACTS OF 62,500 POUNDS STERLING)"
25/07/2000,GBP,1.5158,-1.26%,0.0125,6.09,-0.54,30688,2662,3620,0,17589,12914,20251,16534,10437,14154,"(CONTRACTS OF 62,500 POUNDS STERLING)"
18/07/2000,GBP,1.497,1.31%,-0.0132,6.05,-0.6,33703,406,6203,0,26872,8081,27278,14284,6425,19419,"(CONTRACTS OF 62,500 POUNDS STERLING)"
11/07/2000,GBP,1.5169,-0.13%,0.0013,6.04,-0.59,27846,1126,4680,0,20373,8821,21499,13501,6347,14345,"(CONTRACTS OF 62,500 POUNDS STERLING)"
05/07/2000,GBP,1.5149,-0.58%,0.0058,6.02,-0.63,28243,2493,4932,0,18830,8035,21323,12967,6920,15276,"(CONTRACTS OF 62,500 POUNDS STERLING)"
27/06/2000,GBP,1.5061,0.76%,-0.0076,6.06,-0.61,26582,0,4662,0,19358,5887,19358,10549,7224,16033,"(CONTRACTS OF 62,500 POUNDS STERLING)"
20/06/2000,GBP,1.5176,-0.78%,0.0078,6.03,-0.65,25945,0,4660,0,19066,6091,19066,10751,6879,15194,"(CONTRACTS OF 62,500 POUNDS STERLING)"
13/06/2000,GBP,1.5058,1.47%,-0.0148,6.13,-0.62,52278,770,8873,0,43446,26247,44216,35120,8062,17158,"(CONTRACTS OF 62,500 POUNDS STERLING)"
06/06/2000,GBP,1.5282,-2.06%,0.0204,6.08,-0.62,50316,770,8789,0,40591,21251,41361,30040,8955,20276,"(CONTRACTS OF 62,500 POUNDS STERLING)"
30/05/2000,GBP,1.4973,-1.40%,0.0139,6.17,-0.65,52836,1249,14223,20,41060,15971,42329,30214,10507,22622,"(CONTRACTS OF 62,500 POUNDS STERLING)"
23/05/2000,GBP,1.4767,1.16%,-0.0116,6.11,-0.66,53580,570,16959,18,43771,14371,44359,31348,9221,22232,"(CONTRACTS OF 62,500 POUNDS STERLING)"
16/05/2000,GBP,1.494,2.39%,-0.0242,6.19,-0.77,49851,570,13694,0,41035,13556,41605,27250,8246,22601,"(CONTRACTS OF 62,500 POUNDS STERLING)"
09/05/2000,GBP,1.5306,1.88%,-0.019,6.22,-0.43,51395,1082,19025,21,44755,15382,45858,34428,5537,16967,"(CONTRACTS OF 62,500 POUNDS STERLING)"
02/05/2000,GBP,1.56,1.33%,-0.0134,6.25,-0.27,52717,1902,19950,14,45440,15432,47356,35396,5361,17321,"(CONTRACTS OF 62,500 POUNDS STERLING)"
25/04/2000,GBP,1.581,-0.27%,0.0027,6.2,-0.02,42813,1266,11935,19,35823,17430,37108,29384,5705,13429,"(CONTRACTS OF 62,500 POUNDS STERLING)"
18/04/2000,GBP,1.5768,0.54%,-0.0054,6.12,-0.05,42051,1737,10436,7,34729,17785,36473,28228,5578,13823,"(CONTRACTS OF 62,500 POUNDS STERLING)"
11/04/2000,GBP,1.5853,0.45%,-0.0045,6.15,-0.07,38671,1945,7707,6,29735,18785,31686,26498,6985,12173,"(CONTRACTS OF 62,500 POUNDS STERLING)"
04/04/2000,GBP,1.5924,-0.25%,0.0025,6.16,-0.06,40719,6122,7242,2,25887,20841,32011,28085,8708,12634,"(CONTRACTS OF 62,500 POUNDS STERLING)"
28/03/2000,GBP,1.5885,-1.01%,0.0101,6.16,-0.03,37843,3404,9078,1,28007,16231,31412,25310,6431,12533,"(CONTRACTS OF 62,500 POUNDS STERLING)"
21/03/2000,GBP,1.5726,0.28%,-0.0028,6.09,-0.07,43392,625,17757,3,34899,11284,35527,29044,7865,14348,"(CONTRACTS OF 62,500 POUNDS STERLING)"
14/03/2000,GBP,1.577,0.15%,-0.0015,6.04,-0.09,43677,627,18417,0,37526,10206,38153,28623,5524,15054,"(CONTRACTS OF 62,500 POUNDS STERLING)"
07/03/2000,GBP,1.5793,-0.06%,0.0006,6.1,0.05,62049,1997,14354,5,51628,31418,53630,45777,8419,16272,"(CONTRACTS OF 62,500 POUNDS STERLING)"
29/02/2000,GBP,1.5784,2.10%,-0.0212,6.15,0.1,51024,1560,16370,31,42339,19536,43930,35937,7094,15087,"(CONTRACTS OF 62,500 POUNDS STERLING)"
22/02/2000,GBP,1.6122,-0.99%,0.0098,6.04,0.04,47438,1454,11895,200,36043,21788,37697,33883,9741,13555,"(CONTRACTS OF 62,500 POUNDS STERLING)"
15/02/2000,GBP,1.5964,0.92%,-0.0093,6.08,0.12,47791,1352,15490,8,39512,17217,40872,32715,6919,15076,"(CONTRACTS OF 62,500 POUNDS STERLING)"
08/02/2000,GBP,1.6113,0.16%,-0.0016,6.16,0.11,48047,1567,17477,2,38588,16174,40157,33653,7890,14394,"(CONTRACTS OF 62,500 POUNDS STERLING)"
01/02/2000,GBP,1.6139,1.83%,-0.0185,6.12,0.07,33949,1918,2119,0,23658,19344,25576,21463,8373,12486,"(CONTRACTS OF 62,500 POUNDS STERLING)"
25/01/2000,GBP,1.644,-0.46%,0.0046,6.06,0.1,47257,20494,402,0,11442,39718,31936,40120,15321,7137,"(CONTRACTS OF 62,500 POUNDS STERLING)"
18/01/2000,GBP,1.6365,0.70%,-0.007,6,0.01,36241,15385,387,0,8314,27930,23699,28317,12542,7924,"(CONTRACTS OF 62,500 POUNDS STERLING)"
11/01/2000,GBP,1.648,-0.70%,0.007,5.96,0.08,36938,14961,853,0,7134,29107,22095,29960,14843,6978,"(CONTRACTS OF 62,500 POUNDS STERLING)"
04/01/2000,GBP,1.6365,-1.38%,0.0137,5.95,-0.1,27070,5767,1724,0,9713,17028,15480,18752,11590,8318,"(CONTRACTS OF 62,500 POUNDS STERLING)"
28/12/1999,GBP,1.6143,-0.16%,0.0015,5.92,-0.08,18786,627,5229,0,13581,4849,14208,10078,4578,8708,"(CONTRACTS OF 62,500 POUNDS STERLING)"
21/12/1999,GBP,1.6118,-0.05%,0.0005,5.96,-0.24,18467,414,4415,0,12905,6172,13319,10587,5148,7880,"(CONTRACTS OF 62,500 POUNDS STERLING)"
14/12/1999,GBP,1.611,0.82%,-0.0083,5.84,-0.26,18990,914,3978,0,11477,6189,12391,10167,6599,8823,"(CONTRACTS OF 62,500 POUNDS STERLING)"
07/12/1999,GBP,1.6244,-1.63%,0.0161,5.87,-0.21,54458,6688,10253,0,39472,32904,46160,43157,8298,11301,"(CONTRACTS OF 62,500 POUNDS STERLING)"
30/11/1999,GBP,1.5984,1.62%,-0.0164,5.81,-0.22,46548,10829,11946,0,28852,20762,39681,32708,6867,13840,"(CONTRACTS OF 62,500 POUNDS STERLING)"
23/11/1999,GBP,1.6248,-0.53%,0.0053,5.51,-0.49,47213,15651,7163,0,23140,30792,38791,37955,8422,9258,"(CONTRACTS OF 62,500 POUNDS STERLING)"
16/11/1999,GBP,1.6162,0.44%,-0.0044,5.65,-0.37,46714,15155,7947,0,23249,28976,38404,36923,8310,9791,"(CONTRACTS OF 62,500 POUNDS STERLING)"
09/11/1999,GBP,1.6233,1.31%,-0.0132,5.76,-0.2,47996,17143,7490,0,22830,31193,39973,38683,8023,9313,"(CONTRACTS OF 62,500 POUNDS STERLING)"
02/11/1999,GBP,1.6448,0.44%,-0.0044,5.93,-0.17,59174,32574,1418,0,11366,49525,43940,50943,15234,8231,"(CONTRACTS OF 62,500 POUNDS STERLING)"
26/10/1999,GBP,1.652,1.20%,-0.0121,5.96,-0.21,61647,35944,1900,54,8616,49311,44614,51265,17033,10382,"(CONTRACTS OF 62,500 POUNDS STERLING)"
19/10/1999,GBP,1.6721,-0.92%,0.0091,5.94,-0.18,74359,48014,4235,0,8404,62711,56418,66946,17941,7413,"(CONTRACTS OF 62,500 POUNDS STERLING)"
12/10/1999,GBP,1.6569,-0.08%,0.0008,5.96,-0.17,63106,39343,3758,0,7913,51482,47256,55240,15850,7866,"(CONTRACTS OF 62,500 POUNDS STERLING)"
05/10/1999,GBP,1.6555,-0.45%,0.0045,6,-0.08,62192,39896,3545,0,6494,51795,46390,55340,15802,6852,"(CONTRACTS OF 62,500 POUNDS STERLING)"
28/09/1999,GBP,1.6481,-0.99%,0.0098,5.33,-0.02,54299,32579,4297,0,6288,42221,38867,46518,15432,7781,"(CONTRACTS OF 62,500 POUNDS STERLING)"
21/09/1999,GBP,1.632,-1.52%,0.0151,5.33,-0.12,34781,13830,4814,0,6608,23287,20438,28101,14343,6680,"(CONTRACTS OF 62,500 POUNDS STERLING)"
14/09/1999,GBP,1.6075,-0.27%,0.0027,5.31,-0.14,34466,14721,4390,0,6017,22126,20738,26516,13728,7950,"(CONTRACTS OF 62,500 POUNDS STERLING)"
07/09/1999,GBP,1.6032,0.00%,0,5.12,-0.3,53262,10018,6075,238,31444,36405,41700,42718,11562,10544,"(CONTRACTS OF 62,500 POUNDS STERLING)"
31/08/1999,GBP,1.6032,-0.55%,0.0055,5.22,-0.22,54879,14833,4051,0,24681,37990,39514,42041,15365,12838,"(CONTRACTS OF 62,500 POUNDS STERLING)"
24/08/1999,GBP,1.5944,0.54%,-0.0054,5.06,-0.39,55277,12378,5067,1,30027,37947,42406,43015,12871,12262,"(CONTRACTS OF 62,500 POUNDS STERLING)"
17/08/1999,GBP,1.6031,0.71%,-0.0071,5.09,-0.32,52821,13792,4354,0,25323,37366,39115,41720,13706,11101,"(CONTRACTS OF 62,500 POUNDS STERLING)"
10/08/1999,GBP,1.6145,0.33%,-0.0033,5.22,-0.2,55315,14846,6561,0,25416,37612,40262,44173,15053,11142,"(CONTRACTS OF 62,500 POUNDS STERLING)"
03/08/1999,GBP,1.6199,-1.85%,0.0184,5.15,-0.14,55026,10125,6581,1575,28466,34379,40166,42535,14860,12491,"(CONTRACTS OF 62,500 POUNDS STERLING)"
27/07/1999,GBP,1.5904,-1.17%,0.0116,5.08,-0.2,57262,2924,29662,0,43752,10427,46676,40089,10586,17173,"(CONTRACTS OF 62,500 POUNDS STERLING)"
20/07/1999,GBP,1.572,-0.94%,0.0093,5.03,-0.18,67257,3187,34882,0,55987,15113,59174,49995,8083,17262,"(CONTRACTS OF 62,500 POUNDS STERLING)"
13/07/1999,GBP,1.5574,0.28%,-0.0028,4.92,-0.29,73339,3470,43767,0,62194,10372,65664,54139,7675,19200,"(CONTRACTS OF 62,500 POUNDS STERLING)"
06/07/1999,GBP,1.5617,0.67%,-0.0068,5,-0.21,69689,2711,41616,0,59141,6931,61852,48547,7837,21142,"(CONTRACTS OF 62,500 POUNDS STERLING)"
29/06/1999,GBP,1.5723,1.14%,-0.0115,4.97,-0.22,62127,3154,37576,39,51633,6931,54826,44546,7301,17581,"(CONTRACTS OF 62,500 POUNDS STERLING)"
22/06/1999,GBP,1.5905,0.22%,-0.0022,5.06,-0.07,48586,2944,25097,39,38682,7317,41665,32453,6921,16133,"(CONTRACTS OF 62,500 POUNDS STERLING)"
15/06/1999,GBP,1.594,0.75%,-0.0075,5.03,-0.09,51176,7516,26526,39,35487,8186,43042,34751,8134,16425,"(CONTRACTS OF 62,500 POUNDS STERLING)"
08/06/1999,GBP,1.606,0.35%,-0.0035,5.12,0.09,66284,6405,24720,208,50202,23818,56815,48746,9469,17538,"(CONTRACTS OF 62,500 POUNDS STERLING)"
01/06/1999,GBP,1.6117,-0.46%,0.0046,5.27,0.29,63155,4064,24566,0,48910,22724,52974,47290,10181,15865,"(CONTRACTS OF 62,500 POUNDS STERLING)"
25/05/1999,GBP,1.6043,0.99%,-0.0099,5.25,0.32,60096,4277,16026,1411,44600,24605,50288,42042,9808,18054,"(CONTRACTS OF 62,500 POUNDS STERLING)"
18/05/1999,GBP,1.6203,0.16%,-0.0016,5.24,0.3,57184,17302,3054,1506,23027,43121,41835,47681,15349,9503,"(CONTRACTS OF 62,500 POUNDS STERLING)"
11/05/1999,GBP,1.6229,0.33%,-0.0033,5.22,0.35,55926,16942,2549,1506,23035,41306,41483,45361,14443,10565,"(CONTRACTS OF 62,500 POUNDS STERLING)"
04/05/1999,GBP,1.6282,-0.71%,0.0071,5.22,0.35,60750,3855,19763,0,43153,30310,47008,50073,13742,10677,"(CONTRACTS OF 62,500 POUNDS STERLING)"
27/04/1999,GBP,1.6167,-0.49%,0.0049,5.22,0.36,61648,1138,24633,0,52014,23628,53152,48261,8496,13387,"(CONTRACTS OF 62,500 POUNDS STERLING)"
20/04/1999,GBP,1.6088,0.45%,-0.0045,5.14,0.2,67131,684,32800,39,59885,20826,60608,53665,6523,13466,"(CONTRACTS OF 62,500 POUNDS STERLING)"
13/04/1999,GBP,1.616,-1.57%,0.0156,5.22,0.28,64984,884,30016,0,57667,20656,58551,50672,6433,14312,"(CONTRACTS OF 62,500 POUNDS STERLING)"
06/04/1999,GBP,1.591,1.30%,-0.0131,5,0.13,68549,1882,29142,0,60391,21185,62273,50327,6276,18222,"(CONTRACTS OF 62,500 POUNDS STERLING)"
30/03/1999,GBP,1.6119,1.60%,-0.0161,5.12,0.18,54416,947,17968,39,46915,23397,47901,41404,6515,13012,"(CONTRACTS OF 62,500 POUNDS STERLING)"
23/03/1999,GBP,1.6381,-0.60%,0.006,5.22,0.35,61850,11122,22318,39,40920,27581,52081,49938,9769,11912,"(CONTRACTS OF 62,500 POUNDS STERLING)"
16/03/1999,GBP,1.6283,-0.62%,0.0062,5.31,0.42,55118,1179,20312,0,46425,21533,47604,41845,7514,13273,"(CONTRACTS OF 62,500 POUNDS STERLING)"
09/03/1999,GBP,1.6182,-0.17%,0.0017,5.34,0.46,83402,4849,32452,298,68922,30868,74069,63618,9333,19784,"(CONTRACTS OF 62,500 POUNDS STERLING)"
02/03/1999,GBP,1.6155,-0.04%,0.0004,5.38,0.44,73910,3747,31513,215,63954,21970,67916,53698,5994,20212,"(CONTRACTS OF 62,500 POUNDS STERLING)"
23/02/1999,GBP,1.6148,1.13%,-0.0113,5.34,0.47,67663,3747,27531,214,58189,21744,62150,49489,5513,18174,"(CONTRACTS OF 62,500 POUNDS STERLING)"
16/02/1999,GBP,1.6332,0.27%,-0.0027,5.19,0.3,56165,3965,18180,204,46334,22241,50503,40625,5662,15540,"(CONTRACTS OF 62,500 POUNDS STERLING)"
09/02/1999,GBP,1.6376,0.09%,-0.0009,5.41,0.5,54792,4386,18042,204,44551,22577,49141,40823,5651,13969,"(CONTRACTS OF 62,500 POUNDS STERLING)"
02/02/1999,GBP,1.639,1.21%,-0.0121,5.69,0.78,56703,4478,18834,0,46687,21854,51165,40688,5538,16015,"(CONTRACTS OF 62,500 POUNDS STERLING)"
26/01/1999,GBP,1.659,-0.12%,0.0012,5.56,0.72,50488,4918,12181,0,39908,23798,44826,35979,5662,14509,"(CONTRACTS OF 62,500 POUNDS STERLING)"
19/01/1999,GBP,1.657,-1.56%,0.0155,5.6,0.77,52148,5700,12965,0,42062,22600,47762,35565,4386,16583,"(CONTRACTS OF 62,500 POUNDS STERLING)"
12/01/1999,GBP,1.6315,1.35%,-0.0136,5.81,0.87,57740,4556,20717,0,48451,19925,53007,40642,4733,17098,"(CONTRACTS OF 62,500 POUNDS STERLING)"
05/01/1999,GBP,1.6539,1.64%,-0.0165,6,1.07,43206,10828,5862,0,26166,26684,36994,32546,6212,10660,"(CONTRACTS OF 62,500 POUNDS STERLING)"
29/12/1998,GBP,1.6814,-0.13%,0.0013,6.13,0.95,46075,15169,2735,0,20642,33905,35811,36640,10264,9435,"(CONTRACTS OF 62,500 POUNDS STERLING)"
22/12/1998,GBP,1.6792,0.31%,-0.0032,6.18,1.06,44144,12476,2735,0,22144,30945,34620,33680,9524,10464,"(CONTRACTS OF 62,500 POUNDS STERLING)"
15/12/1998,GBP,1.6845,-1.61%,0.016,6.31,1.09,47847,16511,3539,0,20666,33939,37177,37478,10670,10369,"(CONTRACTS OF 62,500 POUNDS STERLING)"
08/12/1998,GBP,1.6578,-0.26%,0.0026,6.25,1.1,64674,4586,15278,4287,48962,29863,57835,49428,6839,15246,"(CONTRACTS OF 62,500 POUNDS STERLING)"
01/12/1998,GBP,1.6535,0.36%,-0.0036,6.78,1.53,57589,4735,15163,0,46547,27079,51282,42242,6307,15347,"(CONTRACTS OF 62,500 POUNDS STERLING)"
24/11/1998,GBP,1.6595,1.01%,-0.0102,6.76,1.54,55379,5042,14604,0,43270,26940,48312,41544,7067,13835,"(CONTRACTS OF 62,500 POUNDS STERLING)"
17/11/1998,GBP,1.6765,-1.10%,0.011,6.81,1.63,52761,5402,12885,0,39752,27984,45154,40869,7607,11892,"(CONTRACTS OF 62,500 POUNDS STERLING)"
10/11/1998,GBP,1.6582,0.02%,-0.0002,6.85,1.54,52884,6037,10702,224,39959,28572,46220,39498,6664,13386,"(CONTRACTS OF 62,500 POUNDS STERLING)"
03/11/1998,GBP,1.6585,1.04%,-0.0105,6.96,1.67,53506,6312,12015,0,39393,28956,45705,40971,7801,12535,"(CONTRACTS OF 62,500 POUNDS STERLING)"
27/10/1998,GBP,1.676,1.94%,-0.0196,6.98,1.83,50305,9602,7494,3,29341,30168,38946,37665,11359,12640,"(CONTRACTS OF 62,500 POUNDS STERLING)"
20/10/1998,GBP,1.7092,-0.19%,0.0019,7,1.88,52335,22048,5487,4,14321,36009,36373,41500,15962,10835,"(CONTRACTS OF 62,500 POUNDS STERLING)"
13/10/1998,GBP,1.706,-1.25%,0.0124,7.15,1.84,52658,23524,5510,4,13760,37213,37288,42727,15370,9931,"(CONTRACTS OF 62,500 POUNDS STERLING)"
06/10/1998,GBP,1.685,1.40%,-0.0141,7.21,1.99,54176,24165,6256,2,14108,35613,38275,41871,15901,12305,"(CONTRACTS OF 62,500 POUNDS STERLING)"
29/09/1998,GBP,1.709,-1.67%,0.0166,7.27,2.02,58454,29192,6401,4,11993,40333,41189,46738,17265,11716,"(CONTRACTS OF 62,500 POUNDS STERLING)"
22/09/1998,GBP,1.6809,-0.30%,0.003,7.3,1.93,51441,23755,5529,0,12479,35127,36234,40656,15207,10785,"(CONTRACTS OF 62,500 POUNDS STERLING)"
15/09/1998,GBP,1.6758,-1.15%,0.0114,7.31,1.93,49541,22488,5632,0,11741,34888,34229,40520,15312,9021,"(CONTRACTS OF 62,500 POUNDS STERLING)"
08/09/1998,GBP,1.6568,1.06%,-0.0106,7.43,1.97,74452,26028,3974,2065,31481,57965,59574,64004,14878,10448,"(CONTRACTS OF 62,500 POUNDS STERLING)"
01/09/1998,GBP,1.6745,-2.20%,0.0217,7.46,1.96,71946,25576,3837,1006,30393,55450,56975,60293,14971,11653,"(CONTRACTS OF 62,500 POUNDS STERLING)"
25/08/1998,GBP,1.6385,-1.36%,0.0135,7.65,2.09,47718,1193,14545,96,37096,17313,38385,31954,9333,15764,"(CONTRACTS OF 62,500 POUNDS STERLING)"
18/08/1998,GBP,1.6165,0.83%,-0.0083,7.65,2.09,63395,1126,27717,114,55305,15549,56545,43380,6850,20015,"(CONTRACTS OF 62,500 POUNDS STERLING)"
11/08/1998,GBP,1.63,0.46%,-0.0046,7.68,2.05,41926,2136,6402,35,31564,20068,33735,26505,8191,15421,"(CONTRACTS OF 62,500 POUNDS STERLING)"
04/08/1998,GBP,1.6375,0.53%,-0.0054,7.6,2.01,40629,2755,5383,35,27904,21405,30694,26823,9935,13806,"(CONTRACTS OF 62,500 POUNDS STERLING)"
28/07/1998,GBP,1.6463,-0.17%,0.0017,7.68,2.09,37872,6697,1966,42,19335,26965,26074,28973,11798,8899,"(CONTRACTS OF 62,500 POUNDS STERLING)"
21/07/1998,GBP,1.6435,-0.57%,0.0057,7.68,2.09,36769,1762,4273,35,25897,20405,27694,24713,9075,12056,"(CONTRACTS OF 62,500 POUNDS STERLING)"
14/07/1998,GBP,1.6342,0.17%,-0.0017,7.5,1.94,37141,3328,4423,35,21693,20835,25056,25293,12085,11848,"(CONTRACTS OF 62,500 POUNDS STERLING)"
07/07/1998,GBP,1.637,1.83%,-0.0185,7.77,2.21,39512,6362,2154,35,20294,26178,26691,28367,12821,11145,"(CONTRACTS OF 62,500 POUNDS STERLING)"
30/06/1998,GBP,1.6675,-0.08%,0.0008,7.59,2,50578,19754,1955,0,15644,39580,35398,41535,15180,9043,"(CONTRACTS OF 62,500 POUNDS STERLING)"
23/06/1998,GBP,1.6661,-0.91%,0.009,7.68,2.11,48874,19032,1900,117,15901,38395,35050,40412,13824,8462,"(CONTRACTS OF 62,500 POUNDS STERLING)"
16/06/1998,GBP,1.6511,-0.92%,0.0092,7.65,2.09,44093,5809,17734,32,27166,14684,33007,32450,11086,11643,"(CONTRACTS OF 62,500 POUNDS STERLING)"
09/06/1998,GBP,1.636,0.15%,-0.0015,7.61,2.05,64130,1168,18045,0,51708,26850,52876,44895,11254,19235,"(CONTRACTS OF 62,500 POUNDS STERLING)"
02/06/1998,GBP,1.6385,-0.21%,0.0021,7.38,1.82,52167,1230,19394,4,42922,15914,44156,35312,8011,16855,"(CONTRACTS OF 62,500 POUNDS STERLING)"
26/05/1998,GBP,1.635,-0.82%,0.0082,7.4,1.81,52744,2303,19216,0,42603,15226,44906,34442,7838,18302,"(CONTRACTS OF 62,500 POUNDS STERLING)"
19/05/1998,GBP,1.6217,0.64%,-0.0065,7.38,1.82,52887,697,19854,0,45827,14231,46524,34085,6363,18802,"(CONTRACTS OF 62,500 POUNDS STERLING)"
12/05/1998,GBP,1.6322,1.73%,-0.0175,7.31,1.75,44675,982,13057,0,35892,14632,36874,27689,7801,16986,"(CONTRACTS OF 62,500 POUNDS STERLING)"
05/05/1998,GBP,1.661,0.27%,-0.0027,7.19,1.63,36791,9073,2942,0,14132,22793,23205,25735,13586,11056,"(CONTRACTS OF 62,500 POUNDS STERLING)"
28/04/1998,GBP,1.6655,0.48%,-0.0048,7.38,1.75,37557,12172,1654,0,8847,25288,21019,26942,16538,10615,"(CONTRACTS OF 62,500 POUNDS STERLING)"
21/04/1998,GBP,1.6735,0.65%,-0.0066,7.38,1.82,47517,18732,935,0,8254,37595,26986,38530,20531,8987,"(CONTRACTS OF 62,500 POUNDS STERLING)"
14/04/1998,GBP,1.6845,-1.04%,0.0103,7.41,1.85,44503,14499,1141,0,8649,35252,23148,36393,21355,8110,"(CONTRACTS OF 62,500 POUNDS STERLING)"
07/04/1998,GBP,1.6672,0.32%,-0.0032,7.31,1.75,38548,13453,1643,0,8047,27586,21500,29229,17048,9319,"(CONTRACTS OF 62,500 POUNDS STERLING)"
31/03/1998,GBP,1.6726,0.09%,-0.0009,7.47,1.88,43166,15274,1684,0,8217,32839,23491,34523,19675,8643,"(CONTRACTS OF 62,500 POUNDS STERLING)"
24/03/1998,GBP,1.6741,0.01%,-0.0001,7.42,1.86,39543,13692,616,0,6690,31214,20382,31830,19161,7713,"(CONTRACTS OF 62,500 POUNDS STERLING)"
17/03/1998,GBP,1.6742,-2.07%,0.0205,7.43,1.87,35189,11754,875,0,5741,27539,17495,28414,17694,6775,"(CONTRACTS OF 62,500 POUNDS STERLING)"
10/03/1998,GBP,1.6403,0.59%,-0.0059,7.34,1.84,32537,2237,2486,0,20643,19383,22880,21869,9657,10668,"(CONTRACTS OF 62,500 POUNDS STERLING)"
03/03/1998,GBP,1.65,-0.03%,0.0003,7.44,1.91,33697,6492,1183,335,14360,23672,21187,25190,12510,8507,"(CONTRACTS OF 62,500 POUNDS STERLING)"
24/02/1998,GBP,1.6495,-1.06%,0.0105,7.4,1.87,33650,4882,1214,852,17584,21954,23318,24020,10332,9630,"(CONTRACTS OF 62,500 POUNDS STERLING)"
17/02/1998,GBP,1.6322,-0.43%,0.0043,7.41,1.91,30225,3449,1834,852,20275,16812,24576,19498,5649,10727,"(CONTRACTS OF 62,500 POUNDS STERLING)"
10/02/1998,GBP,1.6252,1.23%,-0.0124,7.34,1.84,30407,3412,1574,909,19109,16784,23430,19267,6977,11140,"(CONTRACTS OF 62,500 POUNDS STERLING)"
03/02/1998,GBP,1.6455,-0.20%,0.002,7.43,1.95,30566,3814,1127,884,17532,18938,22230,20949,8336,9617,"(CONTRACTS OF 62,500 POUNDS STERLING)"
27/01/1998,GBP,1.6422,-0.98%,0.0098,7.4,1.88,31215,4405,1129,857,15329,19589,20591,21575,10624,9640,"(CONTRACTS OF 62,500 POUNDS STERLING)"
20/01/1998,GBP,1.6262,0.45%,-0.0045,7.38,1.88,35925,2985,7225,879,25488,11601,29352,19705,6573,16220,"(CONTRACTS OF 62,500 POUNDS STERLING)"
13/01/1998,GBP,1.6336,-0.60%,0.006,7.25,1.75,34890,2721,7281,878,23020,13302,26619,21461,8271,13429,"(CONTRACTS OF 62,500 POUNDS STERLING)"
06/01/1998,GBP,1.6238,1.91%,-0.0193,7.47,1.85,32850,2917,6537,854,20306,12729,24077,20120,8773,12730,"(CONTRACTS OF 62,500 POUNDS STERLING)"
30/12/1997,GBP,1.6555,0.69%,-0.0069,7.48,1.8,31750,3811,4192,859,17981,15738,22651,20789,9099,10961,"(CONTRACTS OF 62,500 POUNDS STERLING)"
23/12/1997,GBP,1.667,-1.96%,0.0194,7.5,1.72,31839,4085,5588,954,18293,14601,23332,21143,8507,10696,"(CONTRACTS OF 62,500 POUNDS STERLING)"
16/12/1997,GBP,1.635,0.99%,-0.0099,7.56,7.56,33808,4784,6440,954,19203,12210,24941,19604,8867,14204,"(CONTRACTS OF 62,500 POUNDS STERLING)"
09/12/1997,GBP,1.6513,1.77%,-0.0178,7.62,7.62,52950,7620,1653,920,32578,37501,41118,40074,11832,12876,"(CONTRACTS OF 62,500 POUNDS STERLING)"
02/12/1997,GBP,1.681,-0.29%,0.0029,7.63,1.77,57669,25660,1317,893,14860,44871,41413,47081,16256,10588,"(CONTRACTS OF 62,500 POUNDS STERLING)"
25/11/1997,GBP,1.6762,0.85%,-0.0085,7.56,1.81,58703,26299,1996,4,14516,42636,40819,44636,17884,14067,"(CONTRACTS OF 62,500 POUNDS STERLING)"
18/11/1997,GBP,1.6905,0.79%,-0.008,7.53,1.78,60001,29977,1536,0,10783,50374,40760,51910,19241,8091,"(CONTRACTS OF 62,500 POUNDS STERLING)"
11/11/1997,GBP,1.704,-1.19%,0.0118,7.5,1.82,56149,25941,1132,0,9590,47378,35531,48510,20618,7639,"(CONTRACTS OF 62,500 POUNDS STERLING)"
04/11/1997,GBP,1.684,-1.05%,0.0104,7.29,1.61,50125,20979,1497,0,9318,40751,30297,42248,19828,7877,"(CONTRACTS OF 62,500 POUNDS STERLING)"
28/10/1997,GBP,1.6665,-1.99%,0.0197,7.21,1.61,52014,21292,1187,0,9323,40236,30615,41423,21399,10591,"(CONTRACTS OF 62,500 POUNDS STERLING)"
21/10/1997,GBP,1.634,-0.80%,0.008,7.31,1.63,35436,3710,3821,0,14280,23723,17990,27544,17446,7892,"(CONTRACTS OF 62,500 POUNDS STERLING)"
14/10/1997,GBP,1.621,0.12%,-0.0012,7.25,1.6,29720,1640,7652,0,17447,12732,19087,20384,10633,9336,"(CONTRACTS OF 62,500 POUNDS STERLING)"
07/10/1997,GBP,1.623,-0.31%,0.0031,7.12,1.56,29740,1640,7417,0,17292,12684,18932,20101,10808,9639,"(CONTRACTS OF 62,500 POUNDS STERLING)"
30/09/1997,GBP,1.618,-0.29%,0.0029,7.25,1.55,28040,999,8306,0,17784,9716,18783,18022,9257,10018,"(CONTRACTS OF 62,500 POUNDS STERLING)"
23/09/1997,GBP,1.6133,-1.08%,0.0108,7.15,1.57,28758,625,10331,0,20998,7270,21623,17601,7135,11157,"(CONTRACTS OF 62,500 POUNDS STERLING)"
16/09/1997,GBP,1.596,-0.38%,0.0038,7.15,1.72,30841,403,11663,0,23823,6477,24226,18140,6615,12701,"(CONTRACTS OF 62,500 POUNDS STERLING)"
09/09/1997,GBP,1.59,-0.03%,0.0003,7.19,1.63,62379,1310,11631,0,44872,27792,46182,39423,16197,22956,"(CONTRACTS OF 62,500 POUNDS STERLING)"
02/09/1997,GBP,1.5895,1.37%,-0.0137,7.18,1.54,49693,1097,12578,0,40426,21450,41523,34028,8170,15665,"(CONTRACTS OF 62,500 POUNDS STERLING)"
26/08/1997,GBP,1.6115,-0.44%,0.0044,6.9,1.3,48989,563,12518,0,40817,22028,41380,34546,7609,14443,"(CONTRACTS OF 62,500 POUNDS STERLING)"
19/08/1997,GBP,1.6045,-1.58%,0.0157,7.15,1.69,49773,590,13929,0,42470,20629,43060,34558,6713,15215,"(CONTRACTS OF 62,500 POUNDS STERLING)"
12/08/1997,GBP,1.5795,2.72%,-0.0276,7.13,1.51,54002,2034,14804,0,44077,20695,46111,35499,7891,18503,"(CONTRACTS OF 62,500 POUNDS STERLING)"
05/08/1997,GBP,1.6237,0.37%,-0.0037,7.09,1.51,49609,4877,10045,0,33343,25301,38220,35346,11389,14263,"(CONTRACTS OF 62,500 POUNDS STERLING)"
29/07/1997,GBP,1.6297,2.85%,-0.0289,7.05,1.49,50192,7707,8537,0,25592,24639,33299,33176,16893,17016,"(CONTRACTS OF 62,500 POUNDS STERLING)"
22/07/1997,GBP,1.6775,0.08%,-0.0008,6.9,1.31,65625,27873,1779,227,16595,56133,44695,58139,20930,7486,"(CONTRACTS OF 62,500 POUNDS STERLING)"
15/07/1997,GBP,1.6788,0.43%,-0.0043,6.75,1.25,64333,28067,1111,293,15303,53835,43663,55239,20670,9094,"(CONTRACTS OF 62,500 POUNDS STERLING)"
08/07/1997,GBP,1.6861,-1.68%,0.0167,6.93,1.31,64098,28036,759,343,12749,55863,41128,56965,22970,7133,"(CONTRACTS OF 62,500 POUNDS STERLING)"
01/07/1997,GBP,1.6582,0.66%,-0.0067,6.75,1.07,54291,22801,815,66,11370,44891,34237,45772,20054,8519,"(CONTRACTS OF 62,500 POUNDS STERLING)"
24/06/1997,GBP,1.6693,-1.85%,0.0183,6.75,1.05,55541,25119,817,54,10107,48456,35280,49327,20261,6214,"(CONTRACTS OF 62,500 POUNDS STERLING)"
17/06/1997,GBP,1.639,-0.15%,0.0015,6.44,0.8,32656,12871,672,71,7084,25686,20026,26429,12630,6227,"(CONTRACTS OF 62,500 POUNDS STERLING)"
10/06/1997,GBP,1.6365,-0.15%,0.0015,6.63,0.94,51246,11098,676,86,27170,41964,38354,42726,12892,8520,"(CONTRACTS OF 62,500 POUNDS STERLING)"
03/06/1997,GBP,1.634,-0.12%,0.0012,6.5,0.86,41825,12109,935,48,16327,33688,28484,34671,13341,7154,"(CONTRACTS OF 62,500 POUNDS STERLING)"
27/05/1997,GBP,1.6321,1.35%,-0.0136,6.44,0.75,41784,11918,951,48,15981,32529,27947,33528,13837,8256,"(CONTRACTS OF 62,500 POUNDS STERLING)"
20/05/1997,GBP,1.6545,-1.33%,0.0132,6.25,0.72,44416,11832,721,395,14405,35736,26632,36852,17784,7564,"(CONTRACTS OF 62,500 POUNDS STERLING)"
13/05/1997,GBP,1.6328,-0.01%,0.0001,6.32,0.61,37463,8768,1398,433,16441,27858,25642,29689,11821,7774,"(CONTRACTS OF 62,500 POUNDS STERLING)"
06/05/1997,GBP,1.6327,-0.09%,0.0009,6.37,0.69,40045,9017,846,479,14618,29015,24114,30340,15931,9705,"(CONTRACTS OF 62,500 POUNDS STERLING)"
29/04/1997,GBP,1.6313,0.12%,-0.0012,6.38,0.7,40777,13165,935,371,12764,31652,26300,32958,14477,7819,"(CONTRACTS OF 62,500 POUNDS STERLING)"
22/04/1997,GBP,1.6332,-0.30%,0.003,6.5,0.82,38726,10502,968,464,13933,29724,24899,31156,13827,7570,"(CONTRACTS OF 62,500 POUNDS STERLING)"
15/04/1997,GBP,1.6283,-0.18%,0.0018,6.46,0.76,36712,9915,1402,532,13903,27500,24350,29434,12362,7278,"(CONTRACTS OF 62,500 POUNDS STERLING)"
08/04/1997,GBP,1.6254,1.60%,-0.0161,6.25,0.55,36422,10169,1182,411,13774,26789,24354,28382,12068,8040,"(CONTRACTS OF 62,500 POUNDS STERLING)"
01/04/1997,GBP,1.6518,-2.04%,0.0202,6.25,0.57,36841,9886,1568,569,14084,26561,24539,28698,12302,8143,"(CONTRACTS OF 62,500 POUNDS STERLING)"
25/03/1997,GBP,1.6188,-1.81%,0.018,6.5,0.89,33460,885,11808,429,24738,9843,26052,22080,7408,11380,"(CONTRACTS OF 62,500 POUNDS STERLING)"
18/03/1997,GBP,1.59,1.03%,-0.0103,6.06,0.53,39630,0,13989,430,34036,9162,34466,23581,5164,16049,"(CONTRACTS OF 62,500 POUNDS STERLING)"
11/03/1997,GBP,1.6065,0.40%,-0.004,6.31,0.87,51948,152,12519,275,44265,25943,44692,38737,7256,13211,"(CONTRACTS OF 62,500 POUNDS STERLING)"
04/03/1997,GBP,1.613,1.33%,-0.0134,6,0.59,38791,1755,9442,594,28813,15834,31162,25870,7629,12921,"(CONTRACTS OF 62,500 POUNDS STERLING)"
25/02/1997,GBP,1.6348,-1.76%,0.0174,6.12,0.81,38965,1990,10103,636,27880,17257,30506,27996,8459,10969,"(CONTRACTS OF 62,500 POUNDS STERLING)"
18/02/1997,GBP,1.6066,1.85%,-0.0186,6.37,1.03,38880,874,10363,630,29697,14753,31201,25746,7679,13134,"(CONTRACTS OF 62,500 POUNDS STERLING)"
11/02/1997,GBP,1.6368,-1.02%,0.0101,6.43,1.12,37223,1492,10152,696,27035,16064,29223,26912,8000,10311,"(CONTRACTS OF 62,500 POUNDS STERLING)"
04/02/1997,GBP,1.6203,-0.14%,0.0014,6.06,0.66,40392,759,12475,648,31470,14747,32877,27870,7515,12522,"(CONTRACTS OF 62,500 POUNDS STERLING)"
28/01/1997,GBP,1.618,2.68%,-0.0271,6.15,0.73,36740,1538,8949,705,27003,14703,29246,24357,7494,12383,"(CONTRACTS OF 62,500 POUNDS STERLING)"
21/01/1997,GBP,1.6625,0.51%,-0.0051,6.31,0.88,39625,11525,1374,665,12621,28122,24811,30161,14814,9464,"(CONTRACTS OF 62,500 POUNDS STERLING)"
14/01/1997,GBP,1.671,1.38%,-0.0138,6.25,0.94,39750,11886,1158,798,12539,28439,25223,30395,14527,9355,"(CONTRACTS OF 62,500 POUNDS STERLING)"
07/01/1997,GBP,1.6943,1.03%,-0.0104,6.56,1.14,44725,15408,680,489,12046,36269,27943,37438,16782,7287,"(CONTRACTS OF 62,500 POUNDS STERLING)"
31/12/1996,GBP,1.712,-2.39%,0.0236,6.56,1.13,42991,17524,893,1242,9107,34203,27873,36338,15118,6653,"(CONTRACTS OF 62,500 POUNDS STERLING)"
24/12/1996,GBP,1.672,-0.11%,0.0011,6.44,0.98,28901,4844,3636,1454,11287,15959,17585,21049,11316,7852,"(CONTRACTS OF 62,500 POUNDS STERLING)"
17/12/1996,GBP,1.6702,-1.03%,0.0102,6.26,0.78,26328,4706,3428,1293,7681,13073,13680,17794,12648,8534,"(CONTRACTS OF 62,500 POUNDS STERLING)"
10/12/1996,GBP,1.6532,-0.56%,0.0056,6.23,0.86,58466,4114,3764,1605,38275,42437,43994,47806,14472,10660,"(CONTRACTS OF 62,500 POUNDS STERLING)"
03/12/1996,GBP,1.644,1.60%,-0.0162,6.12,0.56,64173,11420,7901,1614,31400,40512,44434,50027,19739,14146,"(CONTRACTS OF 62,500 POUNDS STERLING)"
26/11/1996,GBP,1.6708,0.28%,-0.0028,6.25,0.87,62272,20937,540,1247,18175,50972,40359,52759,21913,9513,"(CONTRACTS OF 62,500 POUNDS STERLING)"
19/11/1996,GBP,1.6755,-1.76%,0.0175,6.25,0.88,64129,22551,801,301,17600,54281,40452,55383,23677,8746,"(CONTRACTS OF 62,500 POUNDS STERLING)"
12/11/1996,GBP,1.6465,-0.02%,0.0002,6.25,0.85,60973,23994,1203,290,14346,50917,38630,52410,22343,8563,"(CONTRACTS OF 62,500 POUNDS STERLING)"
05/11/1996,GBP,1.6462,-2.32%,0.023,6.18,0.81,59894,24265,1355,37,14452,50831,38754,52223,21140,7671,"(CONTRACTS OF 62,500 POUNDS STERLING)"
29/10/1996,GBP,1.6088,-0.64%,0.0064,5.76,0.39,58025,25819,2113,48,11668,48757,37535,50918,20490,7107,"(CONTRACTS OF 62,500 POUNDS STERLING)"
22/10/1996,GBP,1.5985,-0.68%,0.0068,5.74,0.34,57540,25160,1829,44,11699,48312,36903,50185,20637,7355,"(CONTRACTS OF 62,500 POUNDS STERLING)"
15/10/1996,GBP,1.5877,-1.64%,0.0163,5.84,0.49,56764,24862,2183,44,11644,48650,36550,50877,20214,5887,"(CONTRACTS OF 62,500 POUNDS STERLING)"
08/10/1996,GBP,1.5621,0.10%,-0.001,5.62,0.23,44569,20256,4234,44,10925,33837,31225,38115,13344,6454,"(CONTRACTS OF 62,500 POUNDS STERLING)"
01/10/1996,GBP,1.5637,0.06%,-0.0006,5.75,0.25,41093,19717,1731,38,8564,33649,28319,35418,12774,5675,"(CONTRACTS OF 62,500 POUNDS STERLING)"
24/09/1996,GBP,1.5647,-0.64%,0.0064,5.54,0.17,39349,18406,1712,38,7552,32298,25996,34048,13353,5301,"(CONTRACTS OF 62,500 POUNDS STERLING)"
17/09/1996,GBP,1.5547,0.08%,-0.0008,5.53,0.03,40033,19209,1362,38,6956,32406,26203,33806,13830,6227,"(CONTRACTS OF 62,500 POUNDS STERLING)"
10/09/1996,GBP,1.556,0.65%,-0.0065,5.68,0.19,69758,19324,1297,452,33129,57780,52905,59529,16853,10229,"(CONTRACTS OF 62,500 POUNDS STERLING)"
03/09/1996,GBP,1.5662,-0.78%,0.0078,5.81,0.31,65298,20235,1301,946,27688,54095,48869,56342,16429,8956,"(CONTRACTS OF 62,500 POUNDS STERLING)"
27/08/1996,GBP,1.5541,-0.39%,0.0039,5.45,0.14,53358,10039,1286,895,30643,43926,41577,46107,11781,7251,"(CONTRACTS OF 62,500 POUNDS STERLING)"
20/08/1996,GBP,1.548,0.05%,-0.0005,5.68,0.31,49320,7124,1684,491,31506,39522,39121,41697,10199,7623,"(CONTRACTS OF 62,500 POUNDS STERLING)"
13/08/1996,GBP,1.5488,-0.65%,0.0065,5.87,0.49,47991,6138,1475,490,31538,38374,38166,40339,9825,7652,"(CONTRACTS OF 62,500 POUNDS STERLING)"
06/08/1996,GBP,1.5388,1.14%,-0.0114,5.84,0.44,49096,8219,2285,238,30007,37942,38464,40465,10632,8631,"(CONTRACTS OF 62,500 POUNDS STERLING)"
30/07/1996,GBP,1.5565,-0.28%,0.0028,5.78,0.22,54359,14799,1123,0,25954,46597,40753,47720,13606,6639,"(CONTRACTS OF 62,500 POUNDS STERLING)"
23/07/1996,GBP,1.5522,0.38%,-0.0038,5.71,0.28,53762,14708,1186,39,25625,46450,40372,47675,13390,6087,"(CONTRACTS OF 62,500 POUNDS STERLING)"
16/07/1996,GBP,1.5581,-0.59%,0.0059,5.74,0.31,60201,20249,608,0,20617,53296,40866,53904,19335,6297,"(CONTRACTS OF 62,500 POUNDS STERLING)"
09/07/1996,GBP,1.549,0.60%,-0.006,5.68,0.09,58784,20824,634,310,20413,51619,41547,52563,17237,6221,"(CONTRACTS OF 62,500 POUNDS STERLING)"
02/07/1996,GBP,1.5583,-1.16%,0.0115,5.84,0.47,48179,18709,2522,313,11022,38324,30044,41159,18135,7020,"(CONTRACTS OF 62,500 POUNDS STERLING)"
25/06/1996,GBP,1.5405,0.22%,-0.0022,5.72,0.29,42155,16627,2097,320,10938,33776,27885,36193,14270,5962,"(CONTRACTS OF 62,500 POUNDS STERLING)"
18/06/1996,GBP,1.5439,-0.58%,0.0058,5.75,0.35,40863,16812,1619,317,8457,34097,25586,36033,15277,4830,"(CONTRACTS OF 62,500 POUNDS STERLING)"
11/06/1996,GBP,1.535,0.81%,-0.0081,5.87,0.44,77714,24614,1699,318,31075,61936,56007,63953,21707,13761,"(CONTRACTS OF 62,500 POUNDS STERLING)"
04/06/1996,GBP,1.5475,-2.21%,0.0219,5.96,0.59,75505,28832,3627,4,29630,61993,58466,65624,17039,9881,"(CONTRACTS OF 62,500 POUNDS STERLING)"
28/05/1996,GBP,1.514,-0.05%,0.0005,6,0.66,51628,8785,8741,4,35444,32750,44233,41495,7395,10133,"(CONTRACTS OF 62,500 POUNDS STERLING)"
21/05/1996,GBP,1.5133,0.08%,-0.0008,6,0.57,47273,8014,8866,4,31486,28655,39504,37525,7769,9748,"(CONTRACTS OF 62,500 POUNDS STERLING)"
14/05/1996,GBP,1.5145,-0.28%,0.0028,5.96,0.65,45694,7575,8013,4,31464,27431,39043,35448,6651,10246,"(CONTRACTS OF 62,500 POUNDS STERLING)"
07/05/1996,GBP,1.5103,-0.28%,0.0028,5.94,0.44,52391,6740,17246,377,40136,20374,47253,37997,5138,14394,"(CONTRACTS OF 62,500 POUNDS STERLING)"
30/04/1996,GBP,1.5061,0.61%,-0.0061,5.93,0.56,61153,6610,17723,456,50200,31162,57266,49341,3887,11812,"(CONTRACTS OF 62,500 POUNDS STERLING)"
23/04/1996,GBP,1.5153,-0.48%,0.0048,6.06,0.75,56917,2569,13100,238,47731,32498,50538,45836,6379,11081,"(CONTRACTS OF 62,500 POUNDS STERLING)"
16/04/1996,GBP,1.508,0.88%,-0.0088,5.91,0.6,66772,2983,20682,142,58402,32380,61527,53204,5245,13568,"(CONTRACTS OF 62,500 POUNDS STERLING)"
09/04/1996,GBP,1.5214,0.19%,-0.0019,5.91,0.73,46709,557,9771,213,39974,26100,40744,36084,5965,10625,"(CONTRACTS OF 62,500 POUNDS STERLING)"
02/04/1996,GBP,1.5243,-0.09%,0.0009,5.96,0.62,49971,1470,10311,6,43255,29254,44731,39571,5240,10400,"(CONTRACTS OF 62,500 POUNDS STERLING)"
26/03/1996,GBP,1.523,0.68%,-0.0069,6.06,0.6,45880,1485,6637,280,38517,28671,40282,35588,5598,10292,"(CONTRACTS OF 62,500 POUNDS STERLING)"
19/03/1996,GBP,1.5335,-0.65%,0.0065,6,0.7,34389,300,6406,413,28651,18452,29364,25271,5025,9118,"(CONTRACTS OF 62,500 POUNDS STERLING)"
12/03/1996,GBP,1.5236,0.42%,-0.0042,6.06,0.81,61581,1310,10765,0,53694,38987,55004,49752,6577,11829,"(CONTRACTS OF 62,500 POUNDS STERLING)"
05/03/1996,GBP,1.53,0.66%,-0.0066,6.03,0.91,53038,4239,4747,0,40241,35733,44480,40480,8558,12558,"(CONTRACTS OF 62,500 POUNDS STERLING)"
27/02/1996,GBP,1.5402,0.30%,-0.003,6.06,0.92,50711,6027,3855,0,34917,36583,40944,40438,9767,10273,"(CONTRACTS OF 62,500 POUNDS STERLING)"
20/02/1996,GBP,1.5448,-0.50%,0.005,6.12,0.94,53470,9280,3534,747,33184,37220,43211,41501,10259,11969,"(CONTRACTS OF 62,500 POUNDS STERLING)"
13/02/1996,GBP,1.5371,0.28%,-0.0028,6.18,1.06,49838,6208,4923,399,33940,30717,40547,36039,9291,13799,"(CONTRACTS OF 62,500 POUNDS STERLING)"
06/02/1996,GBP,1.5414,-2.41%,0.0238,6.12,0.98,44161,4356,6219,0,31955,23538,36311,29757,7850,14404,"(CONTRACTS OF 62,500 POUNDS STERLING)"
30/01/1996,GBP,1.5051,0.57%,-0.0057,6.18,1,50988,745,21586,3,45011,11658,45759,33247,5229,17741,"(CONTRACTS OF 62,500 POUNDS STERLING)"
23/01/1996,GBP,1.5137,1.40%,-0.0141,6.22,0.92,43863,345,17240,3,38694,10380,39042,27623,4821,16240,"(CONTRACTS OF 62,500 POUNDS STERLING)"
16/01/1996,GBP,1.5352,0.92%,-0.0093,6.38,1.05,33713,7023,2052,2,20445,19009,27470,21063,6243,12650,"(CONTRACTS OF 62,500 POUNDS STERLING)"
09/01/1996,GBP,1.5495,0.30%,-0.003,6.38,0.97,36678,8622,1003,2,21029,25189,29653,26194,7025,10484,"(CONTRACTS OF 62,500 POUNDS STERLING)"
02/01/1996,GBP,1.5542,0.34%,-0.0034,6.4,0.97,30668,6607,2045,0,17414,18959,24021,21004,6647,9664,"(CONTRACTS OF 62,500 POUNDS STERLING)"
26/12/1995,GBP,1.5595,-1.15%,0.0114,6.62,1.12,34130,4633,6560,0,22823,15046,27456,21606,6674,12524,"(CONTRACTS OF 62,500 POUNDS STERLING)"
19/12/1995,GBP,1.5418,-0.57%,0.0057,6.62,1.12,32723,268,12563,0,28310,7466,28578,20029,4145,12694,"(CONTRACTS OF 62,500 POUNDS STERLING)"
12/12/1995,GBP,1.533,0.62%,-0.0062,6.44,0.78,66057,268,14369,0,58503,31482,58771,45851,7286,20206,"(CONTRACTS OF 62,500 POUNDS STERLING)"
05/12/1995,GBP,1.5425,0.05%,-0.0005,6.44,0.79,53421,0,16525,269,47330,20890,47599,37684,5822,15737,"(CONTRACTS OF 62,500 POUNDS STERLING)"
28/11/1995,GBP,1.5433,0.89%,-0.009,6.68,0.99,48657,362,15740,0,42013,19680,42375,35420,6282,13237,"(CONTRACTS OF 62,500 POUNDS STERLING)"
21/11/1995,GBP,1.5572,0.10%,-0.001,6.62,0.78,51499,345,18689,0,45964,18787,46309,37476,5190,14023,"(CONTRACTS OF 62,500 POUNDS STERLING)"
14/11/1995,GBP,1.5588,1.37%,-0.0138,6.81,1.19,42391,1629,11223,24,35381,20190,37034,31437,5357,10954,"(CONTRACTS OF 62,500 POUNDS STERLING)"
07/11/1995,GBP,1.5805,-0.03%,0.0003,6.59,0.89,36938,9621,625,24,19726,30541,29371,31190,7567,5748,"(CONTRACTS OF 62,500 POUNDS STERLING)"
31/10/1995,GBP,1.58,-0.10%,0.0009,6.62,0.81,35694,9240,853,24,19016,28993,28280,29870,7414,5824,"(CONTRACTS OF 62,500 POUNDS STERLING)"
24/10/1995,GBP,1.5785,-0.45%,0.0044,7.25,1.44,34207,9419,618,24,17346,27568,26789,28210,7418,5997,"(CONTRACTS OF 62,500 POUNDS STERLING)"
17/10/1995,GBP,1.5715,0.34%,-0.0034,7.12,1.37,35799,9132,638,0,19133,29535,28265,30173,7534,5626,"(CONTRACTS OF 62,500 POUNDS STERLING)"
10/10/1995,GBP,1.5768,0.35%,-0.0035,6.69,0.96,36393,9312,1345,0,19239,29596,28551,30941,7842,5452,"(CONTRACTS OF 62,500 POUNDS STERLING)"
03/10/1995,GBP,1.5823,-1.02%,0.0101,6.75,0.97,31204,9029,2979,0,13937,22903,22966,25882,8238,5322,"(CONTRACTS OF 62,500 POUNDS STERLING)"
26/09/1995,GBP,1.5664,-1.33%,0.0132,6.81,1.11,30065,9070,2605,3,13249,21807,22322,24415,7743,5650,"(CONTRACTS OF 62,500 POUNDS STERLING)"
19/09/1995,GBP,1.5459,0.63%,-0.0063,6.65,0.99,32310,855,14404,21,26300,4691,27176,19116,5134,13194,"(CONTRACTS OF 62,500 POUNDS STERLING)"
12/09/1995,GBP,1.5557,0.11%,-0.0011,6.62,0.94,48364,850,14471,323,40746,19953,41919,34747,6445,13617,"(CONTRACTS OF 62,500 POUNDS STERLING)"
05/09/1995,GBP,1.5574,-0.93%,0.0092,6.69,1.07,37942,1089,13021,21,32202,10864,33312,23906,4630,14036,"(CONTRACTS OF 62,500 POUNDS STERLING)"
29/08/1995,GBP,1.5431,-0.63%,0.0062,6.69,0.94,40216,1507,14489,21,33780,10961,35308,25471,4908,14745,"(CONTRACTS OF 62,500 POUNDS STERLING)"
22/08/1995,GBP,1.5335,1.12%,-0.0112,6.68,0.81,39360,984,15629,21,33133,8105,34138,23755,5222,15605,"(CONTRACTS OF 62,500 POUNDS STERLING)"
15/08/1995,GBP,1.5508,3.17%,-0.0322,6.81,1,36871,1296,11746,45,29806,11531,31147,23322,5724,13549,"(CONTRACTS OF 62,500 POUNDS STERLING)"
08/08/1995,GBP,1.6015,0.27%,-0.0027,6.75,1.03,29924,6455,3631,0,10769,18598,17224,22229,12700,7695,"(CONTRACTS OF 62,500 POUNDS STERLING)"
01/08/1995,GBP,1.6059,-0.96%,0.0096,6.81,1.06,26290,3990,5975,46,13508,13316,17544,19337,8746,6953,"(CONTRACTS OF 62,500 POUNDS STERLING)"
25/07/1995,GBP,1.5906,0.26%,-0.0026,6.75,0.96,24866,0,6953,19,19217,9859,19236,16831,5630,8035,"(CONTRACTS OF 62,500 POUNDS STERLING)"
18/07/1995,GBP,1.5948,-0.46%,0.0046,6.81,1.09,22817,213,5309,19,15977,10354,16209,15682,6608,7135,"(CONTRACTS OF 62,500 POUNDS STERLING)"
11/07/1995,GBP,1.5875,0.84%,-0.0085,6.68,0.96,22967,0,5727,19,17574,9092,17593,14838,5374,8129,"(CONTRACTS OF 62,500 POUNDS STERLING)"
03/07/1995,GBP,1.601,-0.93%,0.0093,6.75,0.9,20776,371,5382,41,15251,7107,15663,12530,5113,8246,"(CONTRACTS OF 62,500 POUNDS STERLING)"
27/06/1995,GBP,1.5862,1.17%,-0.0118,6.87,1.02,20555,560,5401,6,15101,7558,15667,12965,4888,7590,"(CONTRACTS OF 62,500 POUNDS STERLING)"
20/06/1995,GBP,1.605,-0.72%,0.0072,6.59,0.7,19393,2133,4559,51,9117,8167,11301,12777,8092,6616,"(CONTRACTS OF 62,500 POUNDS STERLING)"
13/06/1995,GBP,1.5935,-0.14%,0.0014,6.5,0.79,36074,435,7111,928,28140,19437,29503,27476,6571,8598,"(CONTRACTS OF 62,500 POUNDS STERLING)"
06/06/1995,GBP,1.5913,0.54%,-0.0055,6.5,0.69,27572,812,7127,1190,18654,11118,20656,19435,6916,8137,"(CONTRACTS OF 62,500 POUNDS STERLING)"
30/05/1995,GBP,1.6,-1.88%,0.0186,6.62,0.69,25232,521,7184,654,17012,9274,18187,17112,7045,8120,"(CONTRACTS OF 62,500 POUNDS STERLING)"
23/05/1995,GBP,1.5705,-0.43%,0.0043,6.5,0.5,28733,984,11811,774,21233,3687,22991,16272,5742,12461,"(CONTRACTS OF 62,500 POUNDS STERLING)"
16/05/1995,GBP,1.5638,1.28%,-0.0128,6.62,0.59,29270,935,11580,819,22340,3695,24094,16094,5176,13176,"(CONTRACTS OF 62,500 POUNDS STERLING)"
09/05/1995,GBP,1.584,1.95%,-0.0197,6.69,0.88,24590,4332,2949,10,12584,12611,16926,15570,7664,9020,"(CONTRACTS OF 62,500 POUNDS STERLING)"
02/05/1995,GBP,1.6155,-0.17%,0.0017,6.94,0.88,23479,4137,1710,40,9982,16535,14159,18285,9320,5194,"(CONTRACTS OF 62,500 POUNDS STERLING)"
25/04/1995,GBP,1.6128,-0.10%,0.001,6.81,0.77,23379,4227,1406,21,10535,15509,14783,16936,8596,6443,"(CONTRACTS OF 62,500 POUNDS STERLING)"
18/04/1995,GBP,1.6112,-1.16%,0.0115,6.5,0.44,22698,4705,1232,21,9564,16054,14290,17307,8408,5391,"(CONTRACTS OF 62,500 POUNDS STERLING)"
11/04/1995,GBP,1.5927,0.83%,-0.0083,6.44,0.32,22800,4251,1465,26,11029,14827,15306,16318,7494,6482,"(CONTRACTS OF 62,500 POUNDS STERLING)"
04/04/1995,GBP,1.606,0.56%,-0.0056,6.56,0.38,23373,5870,2138,42,9663,15832,15575,18012,7798,5361,"(CONTRACTS OF 62,500 POUNDS STERLING)"
28/03/1995,GBP,1.615,-1.91%,0.0189,6.56,0.44,22937,5640,1825,316,9281,14716,15237,16857,7700,6080,"(CONTRACTS OF 62,500 POUNDS STERLING)"
21/03/1995,GBP,1.5848,-0.08%,0.0008,6.62,0.52,20876,5261,1784,42,9045,11353,14348,13179,6528,7697,"(CONTRACTS OF 62,500 POUNDS STERLING)"
14/03/1995,GBP,1.5835,3.42%,-0.0348,6.56,0.44,53422,6382,2274,42,7874,12139,14298,14455,39124,38967,"(CONTRACTS OF 62,500 POUNDS STERLING)"
07/03/1995,GBP,1.6395,-3.60%,0.0354,6.63,0.51,58604,10600,1939,416,30403,44579,41419,46934,17185,11670,"(CONTRACTS OF 62,500 POUNDS STERLING)"
28/02/1995,GBP,1.5825,0.22%,-0.0022,6.62,0.5,50942,4114,8710,936,34492,31482,39542,41128,11400,9814,"(CONTRACTS OF 62,500 POUNDS STERLING)"
21/02/1995,GBP,1.586,-1.54%,0.0153,6.68,0.57,48575,2224,10348,1454,34590,26889,38268,38691,10307,9884,"(CONTRACTS OF 62,500 POUNDS STERLING)"
14/02/1995,GBP,1.5619,-0.36%,0.0036,6.75,0.63,46244,1992,11654,1437,33872,22094,37301,35185,8943,11059,"(CONTRACTS OF 62,500 POUNDS STERLING)"
07/02/1995,GBP,1.5563,1.41%,-0.0142,6.68,0.56,40512,2337,14246,1376,27050,15289,30763,30911,9749,9601,"(CONTRACTS OF 62,500 POUNDS STERLING)"
31/01/1995,GBP,1.5785,1.14%,-0.0115,6.71,0.59,42756,6156,10856,1167,22847,22112,30170,34135,12586,8621,"(CONTRACTS OF 62,500 POUNDS STERLING)"
24/01/1995,GBP,1.5967,-1.93%,0.0191,6.62,0.41,47147,6690,10558,1156,24168,25436,32014,37150,15133,9997,"(CONTRACTS OF 62,500 POUNDS STERLING)"
17/01/1995,GBP,1.5665,-0.33%,0.0033,6.37,0.25,37986,2811,15708,1281,26236,11431,30328,28420,7658,9566,"(CONTRACTS OF 62,500 POUNDS STERLING)"
10/01/1995,GBP,1.5613,0.10%,-0.001,6.5,0.32,56015,1853,17744,1056,46195,24532,49104,43332,6911,12683,"(CONTRACTS OF 62,500 POUNDS STERLING)"
03/01/1995,GBP,1.5629,-1.13%,0.0112,6.47,0.16,54250,1797,17240,1019,43761,25668,46577,43927,7673,10323,"(CONTRACTS OF 62,500 POUNDS STERLING)"
27/12/1994,GBP,1.5455,0.94%,-0.0094,6.31,0.13,58849,2197,25361,341,50000,17506,52538,43208,6311,15641,"(CONTRACTS OF 62,500 POUNDS STERLING)"
20/12/1994,GBP,1.5601,-0.07%,0.0007,6.25,0.19,73360,4706,16042,584,36038,18607,41328,35233,32032,38127,"(CONTRACTS OF 62,500 POUNDS STERLING)"
13/12/1994,GBP,1.559,0.16%,-0.0016,6.37,0.06,72973,4495,23933,1589,57099,32160,63183,57682,9790,15291,"(CONTRACTS OF 62,500 POUNDS STERLING)"
06/12/1994,GBP,1.5615,0.02%,-0.0002,6.37,0.19,72635,5777,23489,1480,54640,21139,61897,46108,10738,26527,"(CONTRACTS OF 62,500 POUNDS STERLING)"
29/11/1994,GBP,1.5618,0.43%,-0.0043,6,0.07,57360,5633,24302,1063,40670,19106,47366,44471,9994,12889,"(CONTRACTS OF 62,500 POUNDS STERLING)"
22/11/1994,GBP,1.5685,0.14%,-0.0014,5.96,0.28,51287,6874,23920,532,32616,16411,40022,40863,11265,10424,"(CONTRACTS OF 62,500 POUNDS STERLING)"
15/11/1994,GBP,1.5707,3.00%,-0.0305,6.03,0.28,46959,11240,14960,288,22693,21687,34221,36935,12738,10024,"(CONTRACTS OF 62,500 POUNDS STERLING)"
08/11/1994,GBP,1.6193,0.81%,-0.0082,6.12,0.37,50144,15905,8555,0,17471,33340,33376,41895,16768,8249,"(CONTRACTS OF 62,500 POUNDS STERLING)"
01/11/1994,GBP,1.6326,0.12%,-0.0012,6,0.45,45599,16285,3806,190,10539,33630,27014,37626,18585,7973,"(CONTRACTS OF 62,500 POUNDS STERLING)"
25/10/1994,GBP,1.6345,-1.31%,0.0131,5.88,0.32,43616,16587,1872,195,8454,33616,25236,35683,18380,7933,"(CONTRACTS OF 62,500 POUNDS STERLING)"
18/10/1994,GBP,1.6133,-2.17%,0.0215,5.75,0.32,44329,16137,2717,197,10051,33206,26385,36120,17944,8209,"(CONTRACTS OF 62,500 POUNDS STERLING)"
11/10/1994,GBP,1.579,0.13%,-0.0013,5.75,0.25,41796,16289,3340,196,8445,30723,24930,34259,16866,7537,"(CONTRACTS OF 62,500 POUNDS STERLING)"
04/10/1994,GBP,1.5811,-0.08%,0.0008,5.88,0.51,33580,14547,1728,204,1877,23635,16628,25567,16952,8013,"(CONTRACTS OF 62,500 POUNDS STERLING)"
27/09/1994,GBP,1.5798,-0.34%,0.0034,5.75,0.63,33279,14342,2467,223,2928,23509,17493,26199,15786,7080,"(CONTRACTS OF 62,500 POUNDS STERLING)"
20/09/1994,GBP,1.5745,-0.71%,0.0071,5.81,0.88,52019,12941,2627,269,2249,22330,15459,25226,36560,26793,"(CONTRACTS OF 62,500 POUNDS STERLING)"
13/09/1994,GBP,1.5634,-0.77%,0.0077,5.62,0.72,50574,9559,5395,1154,24491,34723,35204,41272,15370,9302,"(CONTRACTS OF 62,500 POUNDS STERLING)"
06/09/1994,GBP,1.5514,-1.13%,0.0112,5.43,0.57,39923,5239,9566,211,20905,20452,26355,30229,13568,9694,"(CONTRACTS OF 62,500 POUNDS STERLING)"
30/08/1994,GBP,1.5341,1.39%,-0.014,5.44,0.57,35612,4067,10685,207,22330,12452,26604,23344,9008,12268,"(CONTRACTS OF 62,500 POUNDS STERLING)"
23/08/1994,GBP,1.5557,-1.09%,0.0108,5.31,0.48,40352,8424,8386,1291,17902,20788,27617,30465,12735,9887,"(CONTRACTS OF 62,500 POUNDS STERLING)"
16/08/1994,GBP,1.539,-0.01%,0.0001,5.5,0.57,34992,5909,8953,1547,16550,13926,24006,24426,10986,10566,"(CONTRACTS OF 62,500 POUNDS STERLING)"
09/08/1994,GBP,1.5388,-0.25%,0.0025,5.44,0.69,32123,5468,9894,205,15621,11420,21294,21519,10829,10604,"(CONTRACTS OF 62,500 POUNDS STERLING)"
02/08/1994,GBP,1.535,-0.71%,0.0071,5.44,0.88,31928,5539,10511,465,15633,10174,21637,21150,10291,10778,"(CONTRACTS OF 62,500 POUNDS STERLING)"
26/07/1994,GBP,1.5242,1.52%,-0.0153,5.19,0.52,32221,6516,10785,643,14774,9349,21933,20777,10288,11444,"(CONTRACTS OF 62,500 POUNDS STERLING)"
19/07/1994,GBP,1.5477,1.31%,-0.0132,5.12,0.69,41394,16333,7058,535,9141,25326,26009,32919,15385,8475,"(CONTRACTS OF 62,500 POUNDS STERLING)"
12/07/1994,GBP,1.5682,-1.59%,0.0158,5.12,0.44,41030,17877,5539,266,4292,27414,22435,33219,18595,7811,"(CONTRACTS OF 62,500 POUNDS STERLING)"
05/07/1994,GBP,1.5436,0.59%,-0.0059,5.12,0.33,39036,18644,3497,236,2705,28030,21585,31763,17451,7273,"(CONTRACTS OF 62,500 POUNDS STERLING)"
28/06/1994,GBP,1.5527,-0.76%,0.0076,5.12,0.56,39103,19227,3030,386,1671,28534,21284,31950,17819,7153,"(CONTRACTS OF 62,500 POUNDS STERLING)"
21/06/1994,GBP,1.541,-1.49%,0.0148,5,0.5,40151,20262,3309,380,790,29163,21432,32852,18719,7299,"(CONTRACTS OF 62,500 POUNDS STERLING)"
14/06/1994,GBP,1.5184,-0.59%,0.0059,5,0.69,50899,15179,3487,169,1136,23170,16484,26826,34415,24073,"(CONTRACTS OF 62,500 POUNDS STERLING)"
07/06/1994,GBP,1.5095,0.07%,-0.0007,5.12,0.71,45412,10045,4524,527,19034,29169,29606,34220,15806,11192,"(CONTRACTS OF 62,500 POUNDS STERLING)"
31/05/1994,GBP,1.5105,-0.35%,0.0034,5.1,0.6,44476,10868,4474,435,17155,28109,28458,33018,16018,11458,"(CONTRACTS OF 62,500 POUNDS STERLING)"
24/05/1994,GBP,1.5053,-0.25%,0.0025,5.02,0.52,46306,11294,4514,1317,17434,29720,30045,35551,16261,10755,"(CONTRACTS OF 62,500 POUNDS STERLING)"
17/05/1994,GBP,1.5016,-0.90%,0.009,5,0.38,46628,11706,4175,1836,16910,30241,30452,36252,16176,10376,"(CONTRACTS OF 62,500 POUNDS STERLING)"
10/05/1994,GBP,1.4882,1.65%,-0.0167,5.12,0.34,42890,11488,4784,706,14178,26206,26372,31696,16518,11194,"(CONTRACTS OF 62,500 POUNDS STERLING)"
03/05/1994,GBP,1.5132,-0.63%,0.0063,5.12,0.83,49464,16819,4437,698,12262,33309,29779,38444,19685,11020,"(CONTRACTS OF 62,500 POUNDS STERLING)"
26/04/1994,GBP,1.5037,-1.58%,0.0157,5.12,1,45341,12655,6414,726,16756,22377,30137,29517,15204,15824,"(CONTRACTS OF 62,500 POUNDS STERLING)"
19/04/1994,GBP,1.4803,-0.27%,0.0027,5.12,1.06,46240,535,15516,547,37702,11814,38784,27877,7456,18363,"(CONTRACTS OF 62,500 POUNDS STERLING)"
12/04/1994,GBP,1.4763,-0.84%,0.0084,5.12,1.24,47239,714,19134,557,38740,8561,40011,28252,7228,18987,"(CONTRACTS OF 62,500 POUNDS STERLING)"
05/04/1994,GBP,1.464,1.40%,-0.0141,5.31,1.38,43406,355,18189,550,32513,6571,33418,25310,9988,18096,"(CONTRACTS OF 62,500 POUNDS STERLING)"
29/03/1994,GBP,1.4848,0.18%,-0.0018,5.18,1.45,31281,2973,8102,318,16477,10757,19768,19177,11513,12104,"(CONTRACTS OF 62,500 POUNDS STERLING)"
22/03/1994,GBP,1.4875,0.17%,-0.0017,5.1,1.42,25174,2939,3897,318,11071,12128,14328,16343,10846,8831,"(CONTRACTS OF 62,500 POUNDS STERLING)"
15/03/1994,GBP,1.49,-0.17%,0.0017,5.12,1.37,45275,3814,3202,417,9510,13032,13741,16651,31534,28624,"(CONTRACTS OF 62,500 POUNDS STERLING)"
08/03/1994,GBP,1.4874,0.11%,-0.0011,5.06,1.25,41508,1497,3394,983,27915,23783,30395,28160,11113,13348,"(CONTRACTS OF 62,500 POUNDS STERLING)"
01/03/1994,GBP,1.489,-0.71%,0.0071,5.06,1.44,48502,845,13071,1055,37429,19353,39329,33479,9173,15023,"(CONTRACTS OF 62,500 POUNDS STERLING)"
22/02/1994,GBP,1.4785,-0.39%,0.0039,5.06,1.56,43197,1978,11843,1474,31728,14491,35180,27808,8017,15389,"(CONTRACTS OF 62,500 POUNDS STERLING)"
15/02/1994,GBP,1.4728,-0.46%,0.0046,5.12,1.75,41666,987,9225,1461,28745,15130,31193,25816,10473,15850,"(CONTRACTS OF 62,500 POUNDS STERLING)"
08/02/1994,GBP,1.466,2.28%,-0.0231,5.06,1.63,40431,1512,8178,978,27239,15820,29729,24976,10702,15455,"(CONTRACTS OF 62,500 POUNDS STERLING)"
01/02/1994,GBP,1.5002,-0.38%,0.0038,5.25,2.07,54526,22481,3429,1498,9262,41302,33241,46229,21285,8297,"(CONTRACTS OF 62,500 POUNDS STERLING)"
25/01/1994,GBP,1.4945,0.09%,-0.0009,5.38,2.26,42142,15848,2821,299,9167,29873,25314,32993,16828,9149,"(CONTRACTS OF 62,500 POUNDS STERLING)"
18/01/1994,GBP,1.4958,-0.46%,0.0046,5.31,2.19,43513,17280,8461,836,8675,25030,26791,34327,16722,9186,"(CONTRACTS OF 62,500 POUNDS STERLING)"
11/01/1994,GBP,1.489,-0.27%,0.0027,5.31,2.19,30991,4308,5779,1168,12012,13388,17488,20335,13503,10656,"(CONTRACTS OF 62,500 POUNDS STERLING)"
04/01/1994,GBP,1.485,1.52%,-0.0153,5.25,2.07,28834,3508,5980,1117,11678,10085,16303,17182,12531,11652,"(CONTRACTS OF 62,500 POUNDS STERLING)"
28/12/1993,GBP,1.5079,-1.34%,0.0133,5.18,2.06,34070,9815,1835,244,4295,23995,14354,26074,19716,7996,"(CONTRACTS OF 62,500 POUNDS STERLING)"
21/12/1993,GBP,1.488,-0.02%,0.0002,5.31,2.13,22959,2344,3182,659,7369,10127,10372,13968,12587,8991,"(CONTRACTS OF 62,500 POUNDS STERLING)"
14/12/1993,GBP,1.4877,0.32%,-0.0032,5.25,2.07,41092,7747,2695,1525,14778,28348,24050,32568,17042,8524,"(CONTRACTS OF 62,500 POUNDS STERLING)"
07/12/1993,GBP,1.4925,-0.47%,0.0047,5.19,1.89,41274,5221,2145,1593,16135,25260,22949,28998,18325,12276,"(CONTRACTS OF 62,500 POUNDS STERLING)"
30/11/1993,GBP,1.4855,-0.03%,0.0003,5.31,1.93,37537,2501,5653,2063,17072,14297,21636,22013,15901,15524,"(CONTRACTS OF 62,500 POUNDS STERLING)"
23/11/1993,GBP,1.485,-0.32%,0.0032,5.31,1.96,36341,1248,8216,1661,21306,10712,24215,20589,12126,15752,"(CONTRACTS OF 62,500 POUNDS STERLING)"
16/11/1993,GBP,1.4803,-0.80%,0.008,5.56,2.25,36927,929,10116,1343,24086,9861,26358,21320,10569,15607,"(CONTRACTS OF 62,500 POUNDS STERLING)"
09/11/1993,GBP,1.4685,0.29%,-0.0029,5.56,2.25,43133,1706,11841,997,27667,7408,30370,20246,12763,22887,"(CONTRACTS OF 62,500 POUNDS STERLING)"
02/11/1993,GBP,1.4728,0.49%,-0.0049,5.62,2.19,36284,2001,9599,411,24564,7937,26976,17947,9308,18337,"(CONTRACTS OF 62,500 POUNDS STERLING)"
26/10/1993,GBP,1.48,0.56%,-0.0056,5.62,2.37,35240,1605,9095,389,23912,8066,25906,17550,9334,17690,"(CONTRACTS OF 62,500 POUNDS STERLING)"
19/10/1993,GBP,1.4883,2.92%,-0.0296,5.69,2.44,31889,2894,7679,504,19196,9360,22594,17543,9295,14346,"(CONTRACTS OF 62,500 POUNDS STERLING)"
12/10/1993,GBP,1.533,-1.11%,0.0111,5.75,2.5,27291,5081,4000,117,7545,15054,12743,19171,14548,8120,"(CONTRACTS OF 62,500 POUNDS STERLING)"
05/10/1993,GBP,1.5161,-0.19%,0.0018,5.88,2.63,24961,3726,2284,13,8450,13108,12189,15405,12772,9556,"(CONTRACTS OF 62,500 POUNDS STERLING)"
28/09/1993,GBP,1.5133,0.11%,-0.0011,5.88,2.82,25234,5083,2286,2,5679,13848,10764,16136,14470,9098,"(CONTRACTS OF 62,500 POUNDS STERLING)"
21/09/1993,GBP,1.515,1.94%,-0.0196,5.81,2.75,26968,6898,2439,83,3844,16045,10825,18567,16143,8401,"(CONTRACTS OF 62,500 POUNDS STERLING)"
14/09/1993,GBP,1.545,-0.44%,0.0043,5.88,2.78,41945,10031,2698,47,9418,27815,19496,30560,22449,11385,"(CONTRACTS OF 62,500 POUNDS STERLING)"
07/09/1993,GBP,1.5383,-3.17%,0.0312,5.8,2.74,47635,9867,3312,1044,12348,31151,23259,35507,24376,12128,"(CONTRACTS OF 62,500 POUNDS STERLING)"
31/08/1993,GBP,1.4911,0.46%,-0.0046,5.84,2.72,34075,3222,9131,1120,17088,9633,21430,19884,12645,14191,"(CONTRACTS OF 62,500 POUNDS STERLING)"
24/08/1993,GBP,1.498,-0.67%,0.0067,5.75,2.63,28887,4263,3637,1150,9773,13563,15186,18350,13701,10537,"(CONTRACTS OF 62,500 POUNDS STERLING)"
17/08/1993,GBP,1.488,-1.45%,0.0143,5.75,2.57,38830,2188,12212,1060,26628,6254,29876,19526,8954,19304,"(CONTRACTS OF 62,500 POUNDS STERLING)"
10/08/1993,GBP,1.4668,2.21%,-0.0224,5.81,2.75,37767,1475,11129,1112,24902,6177,27489,18418,10278,19349,"(CONTRACTS OF 62,500 POUNDS STERLING)"
03/08/1993,GBP,1.5,-0.81%,0.008,5.75,2.57,25966,1463,5563,571,12651,7854,14685,13988,11281,11978,"(CONTRACTS OF 62,500 POUNDS STERLING)"
27/07/1993,GBP,1.488,1.57%,-0.0159,5.9,2.72,26754,1365,4444,420,13365,7274,15150,12138,11604,14616,"(CONTRACTS OF 62,500 POUNDS STERLING)"
20/07/1993,GBP,1.5118,-0.99%,0.0098,5.93,2.81,24537,1245,4689,478,10935,6329,12658,11496,11879,13041,"(CONTRACTS OF 62,500 POUNDS STERLING)"
13/07/1993,GBP,1.497,0.37%,-0.0037,5.9,2.72,27070,1639,5547,398,15292,5816,17329,11761,9741,15309,"(CONTRACTS OF 62,500 POUNDS STERLING)"
06/07/1993,GBP,1.5025,0.66%,-0.0066,5.73,2.55,22666,1218,5459,413,11764,5322,13395,11194,9271,11472,"(CONTRACTS OF 62,500 POUNDS STERLING)"
29/06/1993,GBP,1.5125,-2.39%,0.0236,5.83,2.65,27652,2301,7175,360,16749,5231,19410,12766,8242,14886,"(CONTRACTS OF 62,500 POUNDS STERLING)"
22/06/1993,GBP,1.4772,2.56%,-0.0259,5.81,2.63,35143,1117,10407,295,24892,6588,26304,17290,8839,17853,"(CONTRACTS OF 62,500 POUNDS STERLING)"
15/06/1993,GBP,1.516,0.20%,-0.002,5.77,2.59,38141,603,5478,0,28495,19016,29098,24494,9043,13647,"(CONTRACTS OF 62,500 POUNDS STERLING)"
08/06/1993,GBP,1.519,2.25%,-0.0228,5.84,2.84,39932,1246,5095,1831,25346,18378,28423,25304,11509,14628,"(CONTRACTS OF 62,500 POUNDS STERLING)"
01/06/1993,GBP,1.554,-0.77%,0.0077,5.75,2.75,38130,5138,2113,1236,13941,25572,20315,28921,17815,9209,"(CONTRACTS OF 62,500 POUNDS STERLING)"
25/05/1993,GBP,1.5421,-0.43%,0.0043,5.88,2.7,35712,6851,1014,986,14104,24121,21941,26121,13771,9591,"(CONTRACTS OF 62,500 POUNDS STERLING)"
18/05/1993,GBP,1.5355,0.31%,-0.0031,6.03,3.03,35802,6812,832,1507,14539,21023,22858,23362,12944,12440,"(CONTRACTS OF 62,500 POUNDS STERLING)"
11/05/1993,GBP,1.5402,1.71%,-0.0173,5.88,2.82,40195,10438,1482,1267,13185,25987,24890,28736,15305,11459,"(CONTRACTS OF 62,500 POUNDS STERLING)"
04/05/1993,GBP,1.567,0.41%,-0.0041,5.94,2.82,43693,12321,1876,635,10139,34105,23095,36616,20598,7077,"(CONTRACTS OF 62,500 POUNDS STERLING)"
27/04/1993,GBP,1.5735,-1.70%,0.0169,6.06,3,45310,13277,2660,273,10679,34488,24229,37421,21081,7889,"(CONTRACTS OF 62,500 POUNDS STERLING)"
20/04/1993,GBP,1.5472,0.73%,-0.0073,5.94,2.82,39068,9759,3028,146,9513,29366,19418,32540,19650,6528,"(CONTRACTS OF 62,500 POUNDS STERLING)"
13/04/1993,GBP,1.5585,-3.01%,0.0296,5.62,2.44,38474,9330,3636,0,9163,27850,18493,31486,19981,6988,"(CONTRACTS OF 62,500 POUNDS STERLING)"
06/04/1993,GBP,1.513,-1.37%,0.0136,5.8,2.68,31878,5567,1402,0,9863,23417,15430,24819,16448,7059,"(CONTRACTS OF 62,500 POUNDS STERLING)"
30/03/1993,GBP,1.4926,-0.58%,0.0058,5.81,2.75,30465,4570,2935,0,11413,18898,15983,21833,14482,8632,"(CONTRACTS OF 62,500 POUNDS STERLING)"
23/03/1993,GBP,1.484,-2.49%,0.0246,5.93,2.75,31060,5383,3379,0,11052,18839,16435,22218,14625,8842,"(CONTRACTS OF 62,500 POUNDS STERLING)"
16/03/1993,GBP,1.448,-0.59%,0.0059,5.78,2.66,53864,3263,12890,8,38691,17193,41962,30091,11902,23773,"(CONTRACTS OF 62,500 POUNDS STERLING)"
09/03/1993,GBP,1.4395,0.55%,-0.0055,5.81,2.69,46274,1561,13452,14,35100,13209,36675,26675,9599,19599,"(CONTRACTS OF 62,500 POUNDS STERLING)"
02/03/1993,GBP,1.4475,0.39%,-0.0039,5.94,2.88,42002,2489,15773,20,29511,8726,32020,24519,9982,17483,"(CONTRACTS OF 62,500 POUNDS STERLING)"
23/02/1993,GBP,1.4532,-0.36%,0.0036,6.12,3.06,42549,3269,16694,254,30886,7742,34409,24690,8140,17859,"(CONTRACTS OF 62,500 POUNDS STERLING)"
16/02/1993,GBP,1.448,-1.27%,0.0126,6.06,2.94,43814,2997,16188,0,31488,7991,34485,24179,9329,19635,"(CONTRACTS OF 62,500 POUNDS STERLING)"
09/02/1993,GBP,1.4298,0.91%,-0.0092,6.12,3,43350,3162,14986,405,31038,7305,34605,22696,8745,20654,"(CONTRACTS OF 62,500 POUNDS STERLING)"
02/02/1993,GBP,1.443,6.21%,-0.0641,6.06,2.94,36652,2268,11219,394,25099,7881,27761,19494,8891,17158,"(CONTRACTS OF 62,500 POUNDS STERLING)"
26/01/1993,GBP,1.5385,0.49%,-0.0049,6,2.94,24608,1847,3450,0,13858,10829,15705,14279,8903,10329,"(CONTRACTS OF 62,500 POUNDS STERLING)"
19/01/1993,GBP,1.546,-0.16%,0.0016,6.94,3.79,22434,1749,2901,202,12571,8976,14522,12079,7912,10355,"(CONTRACTS OF 62,500 POUNDS STERLING)"
12/01/1993,GBP,1.5435,0.41%,-0.0041,7.06,3.81,24625,1703,3754,234,13543,8787,15480,12775,9145,11850,"(CONTRACTS OF 62,500 POUNDS STERLING)"
05/01/1993,GBP,1.5498,-2.79%,0.0275,7.12,3.87,32160,1369,10247,0,23590,4819,24959,15066,7201,17094,"(CONTRACTS OF 62,500 POUNDS STERLING)"
29/12/1992,GBP,1.5078,1.80%,-0.0182,7,3.5,33982,1231,11635,0,26910,4121,28141,15756,5841,18226,"(CONTRACTS OF 62,500 POUNDS STERLING)"
22/12/1992,GBP,1.5355,2.01%,-0.0203,7.18,3.81,22660,1159,5433,0,14658,4401,15817,9834,6843,12826,"(CONTRACTS OF 62,500 POUNDS STERLING)"
15/12/1992,GBP,1.567,1.97%,-0.0199,7,3.13,30371,1643,3405,0,21057,16901,22700,20306,7671,10065,"(CONTRACTS OF 62,500 POUNDS STERLING)"
08/12/1992,GBP,1.5985,-3.30%,0.0324,6.93,3.31,30834,1749,3735,800,18827,14109,21376,18644,9458,12190,"(CONTRACTS OF 62,500 POUNDS STERLING)"
01/12/1992,GBP,1.5475,-1.48%,0.0146,7.19,3.38,31916,959,7137,877,21322,9079,23158,17093,8758,14823,"(CONTRACTS OF 62,500 POUNDS STERLING)"
24/11/1992,GBP,1.525,-0.20%,0.002,7,3.32,33205,259,9086,545,23498,7100,24302,16731,8903,16474,"(CONTRACTS OF 62,500 POUNDS STERLING)"
17/11/1992,GBP,1.522,-0.40%,0.0039,7.1,3.35,32888,252,8468,658,22902,7466,23812,16592,9076,16296,"(CONTRACTS OF 62,500 POUNDS STERLING)"
10/11/1992,GBP,1.516,2.21%,-0.0224,6.88,3.45,33135,864,8541,612,23046,7917,24522,17070,8613,16065,"(CONTRACTS OF 62,500 POUNDS STERLING)"
03/11/1992,GBP,1.5503,1.68%,-0.0169,7.31,3.81,32817,839,9186,431,22627,6748,23897,16365,8920,16452,"(CONTRACTS OF 62,500 POUNDS STERLING)"
27/10/1992,GBP,1.5768,2.91%,-0.0295,7.69,4.38,31365,462,8315,464,22104,6592,23030,15371,8335,15994,"(CONTRACTS OF 62,500 POUNDS STERLING)"
20/10/1992,GBP,1.624,5.36%,-0.0551,7.5,4.07,29460,2020,8109,449,19798,5663,22267,14221,7193,15239,"(CONTRACTS OF 62,500 POUNDS STERLING)"
13/10/1992,GBP,1.716,-0.23%,0.0023,8.5,5.19,29465,290,7518,370,22498,6693,23158,14581,6307,14884,"(CONTRACTS OF 62,500 POUNDS STERLING)"
06/10/1992,GBP,1.712,4.03%,-0.0411,8.94,5.88,29628,1129,8780,301,23808,6213,25238,15294,4390,14334,"(CONTRACTS OF 62,500 POUNDS STERLING)"
30/09/1992,GBP,1.7838,-4.00%,0.04,9,6,29099,1430,8403,987,22013,5908,24430,15298,4669,13801,"(CONTRACTS OF 62,500 POUNDS STERLING)"
30/12/2008,JPY,90.28,-0.14%,-0.0014,0.72,-0.84,105926,57793,13917,72,25447,73898,83312,87887,22614,18039,"(CONTRACTS OF JPY 12,500,000)"
22/12/2008,JPY,90.15,-1.37%,-0.0136,1.17,-0.57,105339,56334,16236,102,25419,71267,81855,87605,23484,17734,"(CONTRACTS OF JPY 12,500,000)"
16/12/2008,JPY,88.93,3.46%,0.0352,1.12,-0.7,110472,59985,18604,72,25067,74010,85124,92686,25348,17786,"(CONTRACTS OF JPY 12,500,000)"
09/12/2008,JPY,92.12,1.34%,0.0135,0.97,-1.08,166059,62978,19719,88,64530,132212,127596,152019,38463,14040,"(CONTRACTS OF JPY 12,500,000)"
02/12/2008,JPY,93.37,1.96%,0.0198,1.77,-1.56,138994,67743,24840,665,43279,98731,111687,124236,27307,14758,"(CONTRACTS OF JPY 12,500,000)"
25/11/2008,JPY,95.24,1.77%,0.0179,0.93,-2.51,131206,62066,24900,1041,46145,95959,109252,121900,21954,9306,"(CONTRACTS OF JPY 12,500,000)"
18/11/2008,JPY,96.96,0.75%,0.0075,1.62,-0.65,129694,46827,22693,769,59015,94368,106611,117830,23083,11864,"(CONTRACTS OF JPY 12,500,000)"
11/11/2008,JPY,97.69,1.93%,0.0195,0.93,-1.49,130102,46353,21842,372,61251,96455,107976,118669,22126,11433,"(CONTRACTS OF JPY 12,500,000)"
04/11/2008,JPY,99.61,-0.88%,-0.0088,0.9,-1.42,129500,46772,20278,236,54352,91675,101360,112189,28140,17311,"(CONTRACTS OF JPY 12,500,000)"
28/10/2008,JPY,98.74,1.60%,0.0162,1,-2.57,143020,51215,19389,204,54901,97807,106320,117400,36700,25620,"(CONTRACTS OF JPY 12,500,000)"
21/10/2008,JPY,100.35,1.79%,0.0181,1.07,-2.43,138768,51441,21320,194,54077,100011,105712,121525,33056,17243,"(CONTRACTS OF JPY 12,500,000)"
14/10/2008,JPY,102.18,-0.84%,-0.0084,1.08,-3.4,132983,51709,21805,197,54900,100556,106806,122558,26177,10425,"(CONTRACTS OF JPY 12,500,000)"
07/10/2008,JPY,101.33,4.43%,0.0453,0.88,-3.82,158003,61557,21744,771,68733,122528,131061,145043,26942,12960,"(CONTRACTS OF JPY 12,500,000)"
30/09/2008,JPY,106.03,-0.50%,-0.005,1.01,-3.32,159908,69373,26351,297,65155,119425,134825,146073,25083,13835,"(CONTRACTS OF JPY 12,500,000)"
23/09/2008,JPY,105.5,0.21%,0.0021,0.7,-3.38,141677,51186,19247,240,67085,108729,118511,128216,23166,13461,"(CONTRACTS OF JPY 12,500,000)"
16/09/2008,JPY,105.72,1.02%,0.0103,0.89,-1.83,132133,50625,24025,333,57162,88537,108120,112895,24013,19238,"(CONTRACTS OF JPY 12,500,000)"
09/09/2008,JPY,106.81,1.68%,0.017,0.89,-1.96,206916,39298,24477,701,143124,161962,183123,187140,23793,19776,"(CONTRACTS OF JPY 12,500,000)"
02/09/2008,JPY,108.64,0.86%,0.0086,0.94,-1.92,205813,38405,43425,943,143631,139542,182979,183910,22834,21903,"(CONTRACTS OF JPY 12,500,000)"
26/08/2008,JPY,109.58,0.10%,0.001,0.72,-2.03,209138,40103,60073,568,146975,124878,187646,185519,21492,23619,"(CONTRACTS OF JPY 12,500,000)"
19/08/2008,JPY,109.69,-0.44%,-0.0044,0.87,-2.04,212982,40933,64071,539,148456,118462,189928,183072,23054,29910,"(CONTRACTS OF JPY 12,500,000)"
12/08/2008,JPY,109.21,-0.85%,-0.0085,0.89,-1.96,208622,46164,59413,547,141077,121647,187788,181607,20834,27015,"(CONTRACTS OF JPY 12,500,000)"
05/08/2008,JPY,108.29,-0.18%,-0.0018,0.9,-1.93,200818,45898,57979,633,130875,119020,177406,177632,23412,23186,"(CONTRACTS OF JPY 12,500,000)"
29/07/2008,JPY,108.1,-0.71%,-0.0071,0.76,-1.95,178959,39162,45442,653,117604,109446,157419,155541,21540,23418,"(CONTRACTS OF JPY 12,500,000)"
22/07/2008,JPY,107.34,-2.59%,-0.0256,0.91,-1.97,187785,48433,37909,644,114167,130431,163244,168984,24541,18801,"(CONTRACTS OF JPY 12,500,000)"
15/07/2008,JPY,104.63,2.61%,0.0264,0.91,-1.96,213992,77600,27495,384,103912,166517,181896,194396,32096,19596,"(CONTRACTS OF JPY 12,500,000)"
08/07/2008,JPY,107.43,-1.28%,-0.0127,0.92,-2.08,175428,40519,35194,529,107907,117123,148955,152846,26473,22582,"(CONTRACTS OF JPY 12,500,000)"
01/07/2008,JPY,106.07,1.64%,0.0165,0.93,-1.89,175598,45189,29184,546,103980,122231,149715,151961,25883,23637,"(CONTRACTS OF JPY 12,500,000)"
24/06/2008,JPY,107.84,0.06%,0.0006,0.92,-1.93,164015,34316,47063,450,105223,90770,139989,138283,24026,25732,"(CONTRACTS OF JPY 12,500,000)"
17/06/2008,JPY,107.91,-0.45%,-0.0045,0.92,-1.97,161544,39989,34132,660,96011,97236,136660,132028,24884,29516,"(CONTRACTS OF JPY 12,500,000)"
10/06/2008,JPY,107.43,-2.25%,-0.0222,0.92,-1.91,202372,43391,35675,821,132747,133166,176959,169662,25413,32710,"(CONTRACTS OF JPY 12,500,000)"
03/06/2008,JPY,105.07,-0.80%,-0.0079,0.92,-1.76,164454,55009,31644,543,82305,100291,137857,132478,26597,31976,"(CONTRACTS OF JPY 12,500,000)"
27/05/2008,JPY,104.24,-0.63%,-0.0063,0.91,-1.73,171688,62907,29603,1147,79024,123067,143078,153817,28610,17871,"(CONTRACTS OF JPY 12,500,000)"
20/05/2008,JPY,103.59,1.14%,0.0114,0.91,-1.73,165388,65203,25155,1636,69969,121168,136808,147959,28580,17429,"(CONTRACTS OF JPY 12,500,000)"
13/05/2008,JPY,104.78,-0.04%,-0.0004,0.91,-1.79,174423,62209,28393,1475,85465,126576,149149,156444,25274,17979,"(CONTRACTS OF JPY 12,500,000)"
06/05/2008,JPY,104.74,-0.69%,-0.0069,0.92,-1.85,169098,69355,20620,1053,72209,126827,142617,148500,26481,20598,"(CONTRACTS OF JPY 12,500,000)"
29/04/2008,JPY,104.02,-1.00%,-0.01,0.92,-1.98,166940,73485,18035,987,64831,129122,139303,148144,27637,18796,"(CONTRACTS OF JPY 12,500,000)"
22/04/2008,JPY,102.99,-1.15%,-0.0114,0.91,-2.09,172737,60353,25266,1008,85279,128494,146640,154768,26097,17969,"(CONTRACTS OF JPY 12,500,000)"
15/04/2008,JPY,101.82,0.76%,0.0076,0.93,-1.82,177514,68950,20978,995,79136,137228,149081,159201,28433,18313,"(CONTRACTS OF JPY 12,500,000)"
08/04/2008,JPY,102.6,-0.76%,-0.0075,0.94,-1.88,182491,70424,27357,971,81728,138845,153123,167173,29368,15318,"(CONTRACTS OF JPY 12,500,000)"
01/04/2008,JPY,101.83,-1.76%,-0.0174,0.9,-1.86,189206,78135,25837,1256,79243,146195,158634,173288,30572,15918,"(CONTRACTS OF JPY 12,500,000)"
25/03/2008,JPY,100.07,-0.08%,-0.0008,0.74,-1.85,196616,88691,22771,1194,76963,158417,166848,182382,29768,14234,"(CONTRACTS OF JPY 12,500,000)"
18/03/2008,JPY,99.99,3.27%,0.0332,0.92,-1.69,193580,82300,26541,1126,76317,150981,159743,178648,33837,14932,"(CONTRACTS OF JPY 12,500,000)"
11/03/2008,JPY,103.37,-0.05%,-0.0005,0.9,-1.87,234069,86383,36230,2080,108059,178301,196522,216611,37547,17458,"(CONTRACTS OF JPY 12,500,000)"
04/03/2008,JPY,103.32,3.68%,0.0375,0.93,-1.94,254859,94654,38369,1407,116355,194159,212416,233935,42443,20924,"(CONTRACTS OF JPY 12,500,000)"
26/02/2008,JPY,107.27,0.45%,0.0046,0.76,-2.31,235856,70188,35899,1372,129969,177118,201529,214389,34327,21467,"(CONTRACTS OF JPY 12,500,000)"
19/02/2008,JPY,107.76,-0.43%,-0.0043,0.74,-2.33,237223,80805,30361,1543,117380,184665,199728,216569,37495,20654,"(CONTRACTS OF JPY 12,500,000)"
12/02/2008,JPY,107.3,-0.49%,-0.0049,0.78,-2.12,231216,73955,30484,1091,120344,175817,195390,207392,35826,23824,"(CONTRACTS OF JPY 12,500,000)"
05/02/2008,JPY,106.78,0.25%,0.0025,0.78,-2.18,225290,83740,29050,1317,104879,175163,189936,205530,35354,19760,"(CONTRACTS OF JPY 12,500,000)"
29/01/2008,JPY,107.05,-0.56%,-0.0056,0.76,-2.48,206162,78810,25882,1121,92355,160498,172286,187501,33876,18661,"(CONTRACTS OF JPY 12,500,000)"
22/01/2008,JPY,106.45,0.27%,0.0027,0.76,-2.56,193308,67896,26054,1330,88117,145237,157343,172621,35965,20687,"(CONTRACTS OF JPY 12,500,000)"
15/01/2008,JPY,106.74,1.99%,0.0201,0.82,-3.13,202548,64712,27513,1666,100897,151888,167275,181067,35273,21481,"(CONTRACTS OF JPY 12,500,000)"
08/01/2008,JPY,108.91,2.40%,0.0243,0.78,-3.51,193786,62356,24883,2034,97448,147328,161838,174245,31948,19541,"(CONTRACTS OF JPY 12,500,000)"
31/12/2007,JPY,111.59,2.19%,0.0222,0.83,-3.9,181412,45107,44187,660,107806,117255,153573,162102,27839,19310,"(CONTRACTS OF JPY 12,500,000)"
24/12/2007,JPY,114.09,-0.64%,-0.0064,0.8,-3.97,180033,46961,42948,979,105179,117336,153119,161263,26914,18770,"(CONTRACTS OF JPY 12,500,000)"
18/12/2007,JPY,113.36,-2.51%,-0.0248,0.92,-4.07,176620,54075,40718,833,92410,118024,147318,159575,29302,17045,"(CONTRACTS OF JPY 12,500,000)"
11/12/2007,JPY,110.58,-0.77%,-0.0077,0.96,-4.32,218614,68557,37654,3737,110434,159788,182728,201179,35886,17435,"(CONTRACTS OF JPY 12,500,000)"
04/12/2007,JPY,109.73,-0.88%,-0.0088,0.85,-4.34,195761,73463,39378,1075,82859,138141,157397,178594,38364,17167,"(CONTRACTS OF JPY 12,500,000)"
27/11/2007,JPY,108.77,1.07%,0.0108,0.88,-4.18,192574,68104,36772,1099,84172,137579,153375,175450,39199,17124,"(CONTRACTS OF JPY 12,500,000)"
20/11/2007,JPY,109.95,0.87%,0.0088,0.85,-4.05,193209,68020,37619,882,83162,134908,152064,173409,41145,19800,"(CONTRACTS OF JPY 12,500,000)"
13/11/2007,JPY,110.92,3.27%,0.0332,0.8,-4,190955,63338,42542,716,86879,126365,150933,169623,40022,21332,"(CONTRACTS OF JPY 12,500,000)"
06/11/2007,JPY,114.67,-0.04%,-0.0004,0.79,-4.02,216041,59945,68842,1015,121629,126869,182589,196726,33452,19315,"(CONTRACTS OF JPY 12,500,000)"
30/10/2007,JPY,114.62,0.12%,0.0012,0.85,-3.88,222002,57461,67410,1053,129666,133709,188180,202172,33822,19830,"(CONTRACTS OF JPY 12,500,000)"
23/10/2007,JPY,114.76,1.80%,0.0181,0.88,-4,225032,46369,67723,1115,145548,134904,193032,203742,32000,21290,"(CONTRACTS OF JPY 12,500,000)"
16/10/2007,JPY,116.86,0.26%,0.0026,0.94,-4.18,228334,45607,84220,1290,149731,117750,196628,203260,31706,25074,"(CONTRACTS OF JPY 12,500,000)"
09/10/2007,JPY,117.17,-1.28%,-0.0127,0.95,-4.2,224347,36321,82078,1256,154402,117142,191979,200476,32368,23871,"(CONTRACTS OF JPY 12,500,000)"
02/10/2007,JPY,115.69,-0.83%,-0.0082,0.96,-4.33,197060,35521,63590,1139,127380,109662,164040,174391,33020,22669,"(CONTRACTS OF JPY 12,500,000)"
25/09/2007,JPY,114.74,1.14%,0.0114,0.9,-4.34,171770,46051,48500,1236,91652,101925,138939,151661,32831,20109,"(CONTRACTS OF JPY 12,500,000)"
18/09/2007,JPY,116.06,-1.58%,-0.0157,0.93,-4.27,168189,41534,62601,1078,93739,84116,136351,147795,31838,20394,"(CONTRACTS OF JPY 12,500,000)"
11/09/2007,JPY,114.25,1.79%,0.018,0.92,-4.79,299538,62733,57148,1205,195252,214810,259190,273163,40348,26375,"(CONTRACTS OF JPY 12,500,000)"
04/09/2007,JPY,116.33,-1.91%,-0.0189,0.9,-4.83,269834,58339,65392,2003,175469,178832,235811,246227,34023,23607,"(CONTRACTS OF JPY 12,500,000)"
28/08/2007,JPY,114.15,0.20%,0.002,0.86,-4.6,276995,66128,56282,2144,173334,195871,241606,254297,35389,22698,"(CONTRACTS OF JPY 12,500,000)"
21/08/2007,JPY,114.38,2.70%,0.0273,0.95,-4.5,273008,61218,59702,2634,173550,187833,237402,250169,35606,22839,"(CONTRACTS OF JPY 12,500,000)"
14/08/2007,JPY,117.55,0.99%,0.0099,0.8,-4.69,278398,57759,79648,3172,178281,169749,239212,252569,39186,25829,"(CONTRACTS OF JPY 12,500,000)"
07/08/2007,JPY,118.72,-0.29%,-0.0029,0.76,-4.56,263905,47110,81603,1227,172806,152366,221143,235196,42762,28709,"(CONTRACTS OF JPY 12,500,000)"
31/07/2007,JPY,118.38,1.37%,0.0138,0.72,-4.58,264271,46600,97762,695,174003,133513,221298,231970,42973,32301,"(CONTRACTS OF JPY 12,500,000)"
24/07/2007,JPY,120.02,1.78%,0.018,0.72,-4.59,284669,51088,143503,1243,188343,106993,240674,251739,43995,32930,"(CONTRACTS OF JPY 12,500,000)"
17/07/2007,JPY,122.2,-0.39%,-0.0039,0.71,-4.6,303595,50431,177204,494,212555,91657,263480,269355,40115,34240,"(CONTRACTS OF JPY 12,500,000)"
10/07/2007,JPY,121.73,0.57%,0.0057,0.7,-4.62,320333,51549,177439,530,226591,104651,278670,282620,41663,37713,"(CONTRACTS OF JPY 12,500,000)"
03/07/2007,JPY,122.43,0.65%,0.0065,0.7,-4.59,326811,43373,198511,534,244264,91434,288171,290479,38640,36332,"(CONTRACTS OF JPY 12,500,000)"
26/06/2007,JPY,123.23,0.10%,0.001,0.71,-4.55,352299,49411,237488,468,264063,77604,313942,315560,38357,36739,"(CONTRACTS OF JPY 12,500,000)"
19/06/2007,JPY,123.35,-1.41%,-0.014,0.7,-4.59,310083,45218,206579,515,227309,65979,273042,273073,37041,37010,"(CONTRACTS OF JPY 12,500,000)"
12/06/2007,JPY,121.64,-0.21%,-0.0021,0.72,-4.56,380532,48791,176353,2091,279030,162878,329912,341322,50620,39210,"(CONTRACTS OF JPY 12,500,000)"
05/06/2007,JPY,121.38,0.21%,0.0021,0.67,-4.61,311288,53781,177787,1097,209829,97812,264707,276696,46581,34592,"(CONTRACTS OF JPY 12,500,000)"
29/05/2007,JPY,121.63,-0.11%,-0.0011,0.66,-4.63,319048,51301,197544,1192,222725,83306,275218,282042,43830,37006,"(CONTRACTS OF JPY 12,500,000)"
22/05/2007,JPY,121.5,-1.06%,-0.0105,0.62,-4.64,326431,52301,204047,1507,230085,83736,283893,289290,42538,37141,"(CONTRACTS OF JPY 12,500,000)"
15/05/2007,JPY,120.23,-0.20%,-0.002,0.64,-4.62,297263,46650,174546,1435,204220,85983,252305,261964,44958,35299,"(CONTRACTS OF JPY 12,500,000)"
08/05/2007,JPY,119.99,-0.22%,-0.0022,0.64,-4.62,284780,51213,163472,1402,190671,84855,243286,249729,41494,35051,"(CONTRACTS OF JPY 12,500,000)"
01/05/2007,JPY,119.73,-1.02%,-0.0102,0.63,-4.63,279868,47618,166400,813,188716,78461,237147,245674,42721,34194,"(CONTRACTS OF JPY 12,500,000)"
24/04/2007,JPY,118.52,0.33%,0.0033,0.62,-4.63,235531,37900,119672,809,158243,82310,196952,202791,38579,32740,"(CONTRACTS OF JPY 12,500,000)"
17/04/2007,JPY,118.91,0.11%,0.0011,0.63,-4.64,234796,43281,113800,883,150691,83251,194855,197934,39941,36862,"(CONTRACTS OF JPY 12,500,000)"
10/04/2007,JPY,119.04,-0.08%,-0.0008,0.58,-4.68,230370,42718,107559,2672,141946,82979,187336,193210,43034,37160,"(CONTRACTS OF JPY 12,500,000)"
03/04/2007,JPY,118.95,-0.92%,-0.0092,0.63,-4.62,221748,36845,100703,2377,140812,81355,180034,184435,41714,37313,"(CONTRACTS OF JPY 12,500,000)"
27/03/2007,JPY,117.86,-0.51%,-0.0051,0.61,-4.64,204073,37765,85245,2480,125945,87199,166190,174924,37883,29149,"(CONTRACTS OF JPY 12,500,000)"
20/03/2007,JPY,117.26,-1.01%,-0.01,0.65,-4.6,176550,34269,84222,1944,98301,63646,134514,149812,42036,26738,"(CONTRACTS OF JPY 12,500,000)"
13/03/2007,JPY,116.09,0.35%,0.0035,0.63,-4.62,281602,38194,91047,5287,185748,143512,229229,239846,52373,41756,"(CONTRACTS OF JPY 12,500,000)"
06/03/2007,JPY,116.5,1.21%,0.0122,0.63,-4.63,278491,30479,93365,5152,202412,146414,238043,244931,40448,33560,"(CONTRACTS OF JPY 12,500,000)"
27/02/2007,JPY,117.93,1.68%,0.017,0.62,-4.63,328295,39383,154009,2820,236369,133677,278572,290506,49723,37789,"(CONTRACTS OF JPY 12,500,000)"
20/02/2007,JPY,119.95,0.95%,0.0095,0.56,-4.74,332216,42286,158481,2246,237985,135354,282517,296081,49699,36135,"(CONTRACTS OF JPY 12,500,000)"
13/02/2007,JPY,121.1,-0.85%,-0.0085,0.48,-4.82,361809,43467,210972,1582,269569,109947,314618,322501,47191,39308,"(CONTRACTS OF JPY 12,500,000)"
06/02/2007,JPY,120.08,1.25%,0.0126,0.47,-4.83,314920,41025,169551,1930,230123,107247,273078,278728,41842,36192,"(CONTRACTS OF JPY 12,500,000)"
30/01/2007,JPY,121.6,0.03%,0.0003,0.41,-4.89,344070,42579,215584,1705,255656,87884,299940,305173,44130,38897,"(CONTRACTS OF 12,500,000 JAPANESE YEN)"
23/01/2007,JPY,121.64,-0.84%,-0.0083,0.45,-4.82,344998,52200,217060,1786,246414,85624,300400,304470,44598,40528,"(CONTRACTS OF 12,500,000 JAPANESE YEN)"
16/01/2007,JPY,120.63,-1.03%,-0.0102,0.55,-4.71,308740,56031,194177,1988,206149,69822,264168,265987,44572,42753,"(CONTRACTS OF 12,500,000 JAPANESE YEN)"
09/01/2007,JPY,119.4,-0.51%,-0.0051,0.56,-4.73,287999,54341,177684,2475,182880,66875,239696,247034,48303,40965,"(CONTRACTS OF 12,500,000 JAPANESE YEN)"
03/01/2007,JPY,118.79,0.28%,0.0028,0.47,-4.79,280541,54819,173411,1738,182315,66903,238872,242052,41669,38489,"(CONTRACTS OF 12,500,000 JAPANESE YEN)"
26/12/2006,JPY,119.12,-0.86%,-0.0086,0.46,-4.84,262764,55629,160543,1657,165030,65428,222316,227628,40448,35136,"(CONTRACTS OF 12,500,000 JAPANESE YEN)"
19/12/2006,JPY,118.1,-1.13%,-0.0112,0.48,-4.82,239042,48950,141469,1058,151142,63344,201150,205871,37892,33171,"(CONTRACTS OF 12,500,000 JAPANESE YEN)"
12/12/2006,JPY,116.78,-1.71%,-0.0169,0.51,-4.78,276919,50622,106182,2976,177991,138635,231589,247793,45330,29126,"(CONTRACTS OF 12,500,000 JAPANESE YEN)"
05/12/2006,JPY,114.82,1.07%,0.0107,0.47,-4.81,268136,62344,85881,2901,153868,150125,219113,238907,49023,29229,"(CONTRACTS OF 12,500,000 JAPANESE YEN)"
28/11/2006,JPY,116.06,1.51%,0.0152,0.45,-4.82,252107,56033,97991,2529,150874,122417,209436,222937,42671,29170,"(CONTRACTS OF 12,500,000 JAPANESE YEN)"
21/11/2006,JPY,117.84,-0.21%,-0.0021,0.44,-4.82,258327,50648,131069,1916,168766,93687,221330,226672,36997,31655,"(CONTRACTS OF 12,500,000 JAPANESE YEN)"
14/11/2006,JPY,117.59,0.09%,0.0009,0.41,-4.88,233573,48106,103118,1904,144572,98891,194582,203913,38991,29660,"(CONTRACTS OF 12,500,000 JAPANESE YEN)"
07/11/2006,JPY,117.7,-0.65%,-0.0065,0.38,-4.9,229063,48102,111614,2418,141299,85210,191819,199242,37244,29821,"(CONTRACTS OF 12,500,000 JAPANESE YEN)"
31/10/2006,JPY,116.94,2.04%,0.0206,0.37,-4.9,226607,46776,106376,1748,139703,87349,188227,195473,38380,31134,"(CONTRACTS OF 12,500,000 JAPANESE YEN)"
24/10/2006,JPY,119.37,-0.66%,-0.0066,0.38,-4.9,282998,50401,187691,1038,195865,57498,247304,246227,35694,36771,"(CONTRACTS OF 12,500,000 JAPANESE YEN)"
17/10/2006,JPY,118.59,0.89%,0.009,0.37,-4.9,261575,53173,165751,411,173899,58427,227483,224589,34092,36986,"(CONTRACTS OF 12,500,000 JAPANESE YEN)"
10/10/2006,JPY,119.66,-1.49%,-0.0148,0.41,-4.9,267803,50595,174193,424,182858,53712,233877,228329,33926,39474,"(CONTRACTS OF 12,500,000 JAPANESE YEN)"
03/10/2006,JPY,117.9,-0.72%,-0.0072,0.37,-4.94,243819,47430,151581,456,165283,55727,213169,207764,30650,36055,"(CONTRACTS OF 12,500,000 JAPANESE YEN)"
26/09/2006,JPY,117.06,0.55%,0.0055,0.36,-4.93,221240,42518,129876,449,150583,55335,193550,185660,27690,35580,"(CONTRACTS OF 12,500,000 JAPANESE YEN)"
19/09/2006,JPY,117.71,0.14%,0.0014,0.36,-4.97,225098,34955,125759,342,160209,62383,195506,188484,29592,36614,"(CONTRACTS OF 12,500,000 JAPANESE YEN)"
12/09/2006,JPY,117.87,-1.55%,-0.0154,0.35,-4.99,275585,34942,134394,910,205621,86590,241473,221894,34112,53691,"(CONTRACTS OF 12,500,000 JAPANESE YEN)"
05/09/2006,JPY,116.07,0.51%,0.0051,0.34,-4.98,228792,32941,102439,449,160209,89614,193599,192502,35193,36290,"(CONTRACTS OF 12,500,000 JAPANESE YEN)"
29/08/2006,JPY,116.66,-0.13%,-0.0013,0.33,-5.01,244441,33920,122249,199,175367,85176,209486,207624,34955,36817,"(CONTRACTS OF 12,500,000 JAPANESE YEN)"
22/08/2006,JPY,116.51,-0.41%,-0.004,0.36,-4.98,227195,30853,105930,97,163702,87185,194652,193212,32543,33983,"(CONTRACTS OF 12,500,000 JAPANESE YEN)"
15/08/2006,JPY,116.04,-0.68%,-0.0067,0.36,-4.99,216492,29646,91920,86,153461,92252,183193,184258,33299,32234,"(CONTRACTS OF 12,500,000 JAPANESE YEN)"
08/08/2006,JPY,115.26,-0.62%,-0.0062,0.34,-5.05,198570,25031,76822,1064,141054,94420,167149,172306,31421,26264,"(CONTRACTS OF 12,500,000 JAPANESE YEN)"
01/08/2006,JPY,114.55,2.23%,0.0225,0.34,-5.08,195626,25391,68375,1076,138866,97439,165333,166890,30293,28736,"(CONTRACTS OF 12,500,000 JAPANESE YEN)"
25/07/2006,JPY,117.16,0.09%,0.0009,0.34,-5.09,208508,26299,103185,86,152876,73589,179261,176860,29247,31648,"(CONTRACTS OF 12,500,000 JAPANESE YEN)"
18/07/2006,JPY,117.27,-2.66%,-0.0263,0.35,-5.1,203567,27724,96773,200,145874,74172,173798,171145,29769,32422,"(CONTRACTS OF 12,500,000 JAPANESE YEN)"
11/07/2006,JPY,114.23,0.48%,0.0048,0.34,-5.12,173470,27639,48343,1064,112062,99551,140765,148958,32705,24512,"(CONTRACTS OF 12,500,000 JAPANESE YEN)"
03/07/2006,JPY,114.78,1.24%,0.0125,0.32,-5.11,168688,25330,49239,707,110040,90220,136077,140166,32611,28522,"(CONTRACTS OF 12,500,000 JAPANESE YEN)"
27/06/2006,JPY,116.22,-1.16%,-0.0115,0.3,-5.16,174066,25190,60762,86,116383,81209,141659,142057,32407,32009,"(CONTRACTS OF 12,500,000 JAPANESE YEN)"
20/06/2006,JPY,114.89,0.38%,0.0038,0.27,-5.11,161290,23877,46884,86,104582,85187,128545,132157,32745,29133,"(CONTRACTS OF 12,500,000 JAPANESE YEN)"
13/06/2006,JPY,115.33,-1.84%,-0.0182,0.27,-5.01,243513,39360,48957,933,157545,152880,197838,202770,45675,40743,"(CONTRACTS OF 12,500,000 JAPANESE YEN)"
06/06/2006,JPY,113.25,-1.02%,-0.0101,0.24,-4.98,201843,47148,26145,714,113610,146902,161472,173761,40371,28082,"(CONTRACTS OF 12,500,000 JAPANESE YEN)"
30/05/2006,JPY,112.11,-0.22%,-0.0022,0.26,-4.92,208512,56019,30278,644,108021,153269,164684,184191,43828,24321,"(CONTRACTS OF 12,500,000 JAPANESE YEN)"
23/05/2006,JPY,111.86,-2.00%,-0.0198,0.14,-5.01,211949,49669,31340,710,116134,154398,166513,186448,45436,25501,"(CONTRACTS OF 12,500,000 JAPANESE YEN)"
16/05/2006,JPY,109.67,1.21%,0.0121,0.15,-4.97,212386,47053,27932,1100,116805,158078,164958,187110,47428,25276,"(CONTRACTS OF 12,500,000 JAPANESE YEN)"
09/05/2006,JPY,111.01,2.04%,0.0206,0.07,-5.04,210545,46769,27925,873,113023,157197,160665,185995,49880,24550,"(CONTRACTS OF 12,500,000 JAPANESE YEN)"
02/05/2006,JPY,113.32,1.30%,0.0131,0.06,-5.04,206400,44389,41700,684,118301,144592,163374,186976,43026,19424,"(CONTRACTS OF 12,500,000 JAPANESE YEN)"
25/04/2006,JPY,114.81,1.90%,0.0192,0.05,-5,201415,40997,47487,476,118831,124394,160304,172357,41111,29058,"(CONTRACTS OF 12,500,000 JAPANESE YEN)"
18/04/2006,JPY,117.03,1.07%,0.0108,0.08,-4.95,202039,38749,79890,360,129443,88624,168552,168874,33487,33165,"(CONTRACTS OF 12,500,000 JAPANESE YEN)"
11/04/2006,JPY,118.3,-0.65%,-0.0064,0.06,-4.94,205630,36213,90684,132,140062,80234,176407,171050,29223,34580,"(CONTRACTS OF 12,500,000 JAPANESE YEN)"
04/04/2006,JPY,117.54,0.32%,0.0032,0.07,-4.9,189732,30603,63319,374,126842,93976,157819,157669,31913,32063,"(CONTRACTS OF 12,500,000 JAPANESE YEN)"
28/03/2006,JPY,117.92,-0.54%,-0.0054,0.07,-4.85,180101,27229,57641,361,125904,90414,153494,148416,26607,31685,"(CONTRACTS OF 12,500,000 JAPANESE YEN)"
21/03/2006,JPY,117.29,0.18%,0.0018,0.02,-4.84,175962,23115,52471,354,123357,93753,146826,146578,29136,29384,"(CONTRACTS OF 12,500,000 JAPANESE YEN)"
14/03/2006,JPY,117.5,0.35%,0.0035,0.06,-4.8,189513,24814,70103,151,135112,85072,160077,155326,29436,34187,"(CONTRACTS OF 12,500,000 JAPANESE YEN)"
07/03/2006,JPY,117.91,-1.87%,-0.0185,0.05,-4.74,248612,36738,78569,346,176747,134264,213831,213179,34781,35433,"(CONTRACTS OF 12,500,000 JAPANESE YEN)"
28/02/2006,JPY,115.75,2.48%,0.0251,0.02,-4.71,201773,41587,64408,216,127801,107765,169604,172389,32169,29384,"(CONTRACTS OF 12,500,000 JAPANESE YEN)"
21/02/2006,JPY,118.69,-1.06%,-0.0106,0.01,-4.71,203465,26959,98143,22,149692,70696,176673,168861,26792,34604,"(CONTRACTS OF 12,500,000 JAPANESE YEN)"
14/02/2006,JPY,117.44,0.53%,0.0053,0.02,-4.66,195644,27560,82617,32,141417,80756,169009,163405,26635,32239,"(CONTRACTS OF 12,500,000 JAPANESE YEN)"
07/02/2006,JPY,118.06,-0.72%,-0.0071,-0.01,-4.65,197898,31219,87566,153,141301,79899,172673,167618,25225,30280,"(CONTRACTS OF 12,500,000 JAPANESE YEN)"
31/01/2006,JPY,117.22,-2.30%,-0.0228,-0.02,-4.7,188724,32287,74032,32,126595,83469,158914,157533,29810,31191,"(CONTRACTS OF 12,500,000 JAPANESE YEN)"
24/01/2006,JPY,114.58,0.68%,0.0068,0.02,-4.52,166600,29698,48976,32,103532,94693,133262,143701,33338,22899,"(CONTRACTS OF 12,500,000 JAPANESE YEN)"
17/01/2006,JPY,115.36,-0.93%,-0.0092,-0.03,-4.6,167681,30062,48321,32,103792,93718,133886,142071,33795,25610,"(CONTRACTS OF 12,500,000 JAPANESE YEN)"
10/01/2006,JPY,114.3,1.62%,0.0163,-0.02,-4.55,169886,30472,50001,36,103194,95280,133702,145317,36184,24569,"(CONTRACTS OF 12,500,000 JAPANESE YEN)"
03/01/2006,JPY,116.18,1.03%,0.0104,0.02,-4.51,155722,22192,46929,144,105548,84108,127884,131181,27838,24541,"(CONTRACTS OF 12,500,000 JAPANESE YEN)"
27/12/2005,JPY,117.39,-0.24%,-0.0024,-0.01,-4.52,148945,16998,39127,122,104516,81452,121636,120701,27309,28244,"(CONTRACTS OF 12,500,000 JAPANESE YEN)"
20/12/2005,JPY,117.11,2.38%,0.024,-0.01,-4.49,139503,12322,38427,72,103665,70812,116059,109311,23444,30192,"(CONTRACTS OF 12,500,000 JAPANESE YEN)"
13/12/2005,JPY,119.96,0.67%,0.0067,-0.02,-4.42,243599,22221,94284,2301,188591,112913,213113,209498,30486,34101,"(CONTRACTS OF 12,500,000 JAPANESE YEN)"
06/12/2005,JPY,120.77,-0.97%,-0.0097,-0.05,-4.43,220313,26712,98355,1683,162475,87806,190870,187844,29443,32469,"(CONTRACTS OF 12,500,000 JAPANESE YEN)"
29/11/2005,JPY,119.61,-0.72%,-0.0071,-0.02,-4.35,206878,22626,86626,488,154396,85604,177510,172718,29368,34160,"(CONTRACTS OF 12,500,000 JAPANESE YEN)"
22/11/2005,JPY,118.76,0.08%,0.0008,-0.02,-4.35,204816,21037,86921,575,155228,83522,176840,171018,27976,33798,"(CONTRACTS OF 12,500,000 JAPANESE YEN)"
15/11/2005,JPY,118.86,-1.40%,-0.0139,-0.03,-4.32,203137,21147,88378,667,155676,80033,177490,169078,25647,34059,"(CONTRACTS OF 12,500,000 JAPANESE YEN)"
08/11/2005,JPY,117.22,-0.47%,-0.0047,-0.03,-4.29,197715,19428,84056,884,152664,80124,172976,165064,24739,32651,"(CONTRACTS OF 12,500,000 JAPANESE YEN)"
01/11/2005,JPY,116.67,-1.48%,-0.0147,-0.02,-4.23,195803,19862,86164,75,150226,74757,170163,160996,25640,34807,"(CONTRACTS OF 12,500,000 JAPANESE YEN)"
25/10/2005,JPY,114.97,0.64%,0.0064,-0.01,-4.17,195218,20098,86780,100,147875,76634,168073,163514,27145,31704,"(CONTRACTS OF 12,500,000 JAPANESE YEN)"
18/10/2005,JPY,115.71,-1.07%,-0.0107,-0.03,-4.13,199678,20214,86855,33,149883,72818,170130,159706,29548,39972,"(CONTRACTS OF 12,500,000 JAPANESE YEN)"
11/10/2005,JPY,114.48,-0.19%,-0.0019,-0.03,-4.08,176161,18745,84780,43,129505,56348,148293,141171,27868,34990,"(CONTRACTS OF 12,500,000 JAPANESE YEN)"
04/10/2005,JPY,114.26,-0.88%,-0.0088,-0.03,-4.05,167979,16352,79651,43,125981,56416,142376,136110,25603,31869,"(CONTRACTS OF 12,500,000 JAPANESE YEN)"
27/09/2005,JPY,113.26,-1.17%,-0.0116,-0.03,-3.96,138571,13469,72535,43,101617,33591,115129,106169,23442,32402,"(CONTRACTS OF 12,500,000 JAPANESE YEN)"
20/09/2005,JPY,111.95,-1.13%,-0.0112,0.01,-3.86,127850,11954,59583,43,93551,39459,105548,99085,22302,28765,"(CONTRACTS OF 12,500,000 JAPANESE YEN)"
13/09/2005,JPY,110.7,-0.97%,-0.0096,-0.01,-3.77,189247,10280,45214,2485,149177,114005,161942,161704,27305,27543,"(CONTRACTS OF 12,500,000 JAPANESE YEN)"
06/09/2005,JPY,109.64,1.41%,0.0142,-0.02,-3.71,175986,8017,42389,1454,151972,121758,161443,165601,14543,10385,"(CONTRACTS OF 12,500,000 JAPANESE YEN)"
30/08/2005,JPY,111.21,-1.16%,-0.0115,-0.03,-3.79,178245,7941,55606,1142,157079,108008,166162,164756,12083,13489,"(CONTRACTS OF 12,500,000 JAPANESE YEN)"
23/08/2005,JPY,109.94,-0.37%,-0.0036,0.01,-3.77,166538,9358,40724,926,128914,101140,139198,142790,27340,23748,"(CONTRACTS OF 12,500,000 JAPANESE YEN)"
16/08/2005,JPY,109.54,2.16%,0.0219,-0.02,-3.76,166923,12423,38808,927,125756,102970,139106,142705,27817,24218,"(CONTRACTS OF 12,500,000 JAPANESE YEN)"
09/08/2005,JPY,111.96,-0.53%,-0.0053,-0.02,-3.71,177994,12768,61428,769,139535,83986,153072,146183,24922,31811,"(CONTRACTS OF 12,500,000 JAPANESE YEN)"
02/08/2005,JPY,111.37,1.04%,0.0105,-0.02,-3.68,165281,9337,52488,436,130470,84655,140243,137579,25038,27702,"(CONTRACTS OF 12,500,000 JAPANESE YEN)"
26/07/2005,JPY,112.54,0.12%,0.0012,-0.02,-3.64,161014,8032,55800,423,128689,75625,137144,131848,23870,29166,"(CONTRACTS OF 12,500,000 JAPANESE YEN)"
19/07/2005,JPY,112.68,-1.72%,-0.0171,-0.02,-3.59,168697,9165,68221,476,133055,67280,142696,135977,26001,32720,"(CONTRACTS OF 12,500,000 JAPANESE YEN)"
12/07/2005,JPY,110.77,0.81%,0.0082,-0.02,-3.56,162959,10830,73906,1544,126369,56864,138743,132314,24216,30645,"(CONTRACTS OF 12,500,000 JAPANESE YEN)"
05/07/2005,JPY,111.68,-1.64%,-0.0162,-0.05,-3.58,156517,11579,63765,1023,120359,61368,132961,126156,23556,30361,"(CONTRACTS OF 12,500,000 JAPANESE YEN)"
28/06/2005,JPY,109.88,-1.59%,-0.0158,-0.05,-3.46,147872,10844,62689,856,112688,53483,124388,117028,23484,30844,"(CONTRACTS OF 12,500,000 JAPANESE YEN)"
21/06/2005,JPY,108.16,1.18%,0.0119,-0.05,-3.48,139726,11128,49102,874,104243,62607,116245,112583,23481,27143,"(CONTRACTS OF 12,500,000 JAPANESE YEN)"
14/06/2005,JPY,109.45,-2.66%,-0.0263,0.01,-3.34,144048,8991,61022,929,112210,53702,122130,115653,21918,28395,"(CONTRACTS OF 12,500,000 JAPANESE YEN)"
07/06/2005,JPY,106.61,1.74%,0.0176,-0.02,-3.32,185988,5295,42406,836,151976,117037,158107,160279,27881,25709,"(CONTRACTS OF 12,500,000 JAPANESE YEN)"
31/05/2005,JPY,108.5,-0.92%,-0.0092,-0.02,-3.29,183593,6467,54902,824,150941,100736,158232,156462,25361,27131,"(CONTRACTS OF 12,500,000 JAPANESE YEN)"
24/05/2005,JPY,107.51,-0.02%,-0.0002,-0.03,-3.22,184022,10629,49460,824,150228,110349,161681,160633,22341,23389,"(CONTRACTS OF 12,500,000 JAPANESE YEN)"
17/05/2005,JPY,107.49,-1.86%,-0.0184,-0.02,-3.19,189032,11663,59546,1,153623,109993,165287,169540,23745,19492,"(CONTRACTS OF 12,500,000 JAPANESE YEN)"
10/05/2005,JPY,105.53,-0.42%,-0.0042,-0.02,-3.2,160836,20771,30334,677,109373,110558,130821,141569,30015,19267,"(CONTRACTS OF 12,500,000 JAPANESE YEN)"
03/05/2005,JPY,105.09,0.91%,0.0092,-0.02,-3.15,160185,21832,35963,714,110032,103296,132578,139973,27607,20212,"(CONTRACTS OF 12,500,000 JAPANESE YEN)"
26/04/2005,JPY,106.06,0.64%,0.0064,-0.03,-3.13,138788,11215,43717,753,102423,71356,114391,115826,24397,22962,"(CONTRACTS OF 12,500,000 JAPANESE YEN)"
19/04/2005,JPY,106.74,0.87%,0.0088,-0.03,-3.05,143178,6927,61624,767,111224,54714,118918,117105,24260,26073,"(CONTRACTS OF 12,500,000 JAPANESE YEN)"
12/04/2005,JPY,107.68,0.45%,0.0045,-0.03,-3.12,133228,11954,56150,647,95502,46209,108103,103006,25125,30222,"(CONTRACTS OF 12,500,000 JAPANESE YEN)"
05/04/2005,JPY,108.17,-0.62%,-0.0062,0.015,-3,127406,9686,46128,681,92614,52801,102981,99610,24425,27796,"(CONTRACTS OF 12,500,000 JAPANESE YEN)"
29/03/2005,JPY,107.5,-1.86%,-0.0184,0.02,-3.02,114268,11033,41222,680,76938,47486,88651,89388,25617,24880,"(CONTRACTS OF 12,500,000 JAPANESE YEN)"
22/03/2005,JPY,105.54,-1.00%,-0.01,-0.03,-2.99,108865,15675,27578,73,65906,59607,81654,87258,27211,21607,"(CONTRACTS OF 12,500,000 JAPANESE YEN)"
15/03/2005,JPY,104.49,0.17%,0.0017,0.01,-2.93,107434,13944,19290,73,64255,70141,78272,89504,29162,17930,"(CONTRACTS OF 12,500,000 JAPANESE YEN)"
08/03/2005,JPY,104.67,-0.24%,-0.0024,-0.02,-2.87,171109,13350,23136,3861,120197,121990,137408,148987,33701,22122,"(CONTRACTS OF 12,500,000 JAPANESE YEN)"
01/03/2005,JPY,104.42,-0.37%,-0.0036,-0.02,-2.87,153631,13422,20545,189,107980,112908,121591,133642,32040,19989,"(CONTRACTS OF 12,500,000 JAPANESE YEN)"
22/02/2005,JPY,104.04,0.34%,0.0034,-0.02,-2.85,154084,14078,40013,784,106405,89940,121267,130737,32817,23347,"(CONTRACTS OF 12,500,000 JAPANESE YEN)"
15/02/2005,JPY,104.39,1.28%,0.0128,-0.02,-2.76,151987,13017,36710,961,109138,92564,123116,130235,28871,21752,"(CONTRACTS OF 12,500,000 JAPANESE YEN)"
08/02/2005,JPY,105.74,-1.96%,-0.0194,-0.02,-2.71,155552,19798,34088,6,101203,98396,121007,132490,34545,23062,"(CONTRACTS OF 12,500,000 JAPANESE YEN)"
01/02/2005,JPY,103.71,0.34%,0.0034,-0.02,-2.73,167125,31214,30815,2,98634,122710,129850,153527,37275,13598,"(CONTRACTS OF 12,500,000 JAPANESE YEN)"
25/01/2005,JPY,104.06,-1.74%,-0.0173,-0.02,-2.66,162182,33608,32684,123,90835,111336,124566,144143,37616,18039,"(CONTRACTS OF 12,500,000 JAPANESE YEN)"
18/01/2005,JPY,102.28,1.03%,0.0103,-0.02,-2.62,171109,39872,31993,1,88284,120135,128157,152129,42952,18980,"(CONTRACTS OF 12,500,000 JAPANESE YEN)"
11/01/2005,JPY,103.34,1.20%,0.0121,-0.02,-2.59,161868,35208,11463,198,92180,130683,127586,142344,34282,19524,"(CONTRACTS OF 12,500,000 JAPANESE YEN)"
04/01/2005,JPY,104.6,-1.50%,-0.0149,-0.02,-2.54,155870,33972,11252,125,88489,126703,122586,138080,33284,17790,"(CONTRACTS OF 12,500,000 JAPANESE YEN)"
28/12/2004,JPY,103.05,1.23%,0.0123,-0.05,-2.51,150488,39240,11487,177,74288,124182,113705,135846,36783,14642,"(CONTRACTS OF 12,500,000 JAPANESE YEN)"
21/12/2004,JPY,104.33,1.12%,0.0112,-0.05,-2.51,145705,33373,12797,196,77292,115698,110861,128691,34844,17014,"(CONTRACTS OF 12,500,000 JAPANESE YEN)"
14/12/2004,JPY,105.51,-2.57%,-0.0253,-0.05,-2.46,145978,33636,12235,177,78433,116473,112246,128885,33732,17093,"(CONTRACTS OF 12,500,000 JAPANESE YEN)"
07/12/2004,JPY,102.87,0.03%,0.0003,-0.05,-2.42,221297,50795,13472,710,126760,184367,178265,198549,43032,22748,"(CONTRACTS OF 12,500,000 JAPANESE YEN)"
30/11/2004,JPY,102.9,0.39%,0.0039,-0.05,-2.39,196960,61276,21916,659,91163,154640,153098,177215,43862,19745,"(CONTRACTS OF 12,500,000 JAPANESE YEN)"
23/11/2004,JPY,103.3,1.94%,0.0196,-0.05,-2.33,190372,56698,23500,695,87732,145559,145125,169754,45247,20618,"(CONTRACTS OF 12,500,000 JAPANESE YEN)"
16/11/2004,JPY,105.34,0.37%,0.0037,-0.05,-2.29,181901,58608,14012,882,80442,148947,139932,163841,41969,18060,"(CONTRACTS OF 12,500,000 JAPANESE YEN)"
09/11/2004,JPY,105.73,0.37%,0.0037,-0.05,-2.26,174751,53757,14664,115,80787,143812,134659,158591,40092,16160,"(CONTRACTS OF 12,500,000 JAPANESE YEN)"
02/11/2004,JPY,106.12,0.65%,0.0065,-0.12,-2.22,162362,46779,9965,457,76264,135782,123500,146204,38862,16158,"(CONTRACTS OF 12,500,000 JAPANESE YEN)"
26/10/2004,JPY,106.81,1.36%,0.0137,-0.08,-2.12,143619,41391,13755,379,64933,113154,106703,127288,36916,16331,"(CONTRACTS OF 12,500,000 JAPANESE YEN)"
19/10/2004,JPY,108.28,1.15%,0.0116,-0.06,-2.06,130921,22884,14319,858,74117,97123,97859,112300,33062,18621,"(CONTRACTS OF 12,500,000 JAPANESE YEN)"
12/10/2004,JPY,109.54,1.47%,0.0148,-0.08,-2.05,117286,12753,19140,60,77058,75111,89871,94311,27415,22975,"(CONTRACTS OF 12,500,000 JAPANESE YEN)"
05/10/2004,JPY,111.17,0.16%,0.0016,-0.08,-2.05,111308,11572,26068,0,77223,57988,88795,84056,22513,27252,"(CONTRACTS OF 12,500,000 JAPANESE YEN)"
28/09/2004,JPY,111.35,-1.49%,-0.0147,-0.08,-1.95,94536,10277,32480,0,62615,34851,72892,67331,21644,27205,"(CONTRACTS OF 12,500,000 JAPANESE YEN)"
21/09/2004,JPY,109.72,-0.09%,-0.0009,-0.08,-1.92,82044,7666,17023,0,49595,45443,57261,62466,24783,19578,"(CONTRACTS OF 12,500,000 JAPANESE YEN)"
14/09/2004,JPY,109.62,-0.22%,-0.0022,-0.12,-1.91,79272,7982,12039,0,47779,50086,55761,62125,23511,17147,"(CONTRACTS OF 12,500,000 JAPANESE YEN)"
07/09/2004,JPY,109.38,-0.25%,-0.0025,-0.06,-1.81,106537,10847,11679,200,66132,74552,77179,86431,29358,20106,"(CONTRACTS OF 12,500,000 JAPANESE YEN)"
31/08/2004,JPY,109.11,0.47%,0.0048,-0.06,-1.77,109198,12753,12228,242,64793,80773,77788,93243,31410,15955,"(CONTRACTS OF 12,500,000 JAPANESE YEN)"
24/08/2004,JPY,109.63,0.19%,0.0019,-0.13,-1.77,108560,12757,13726,223,67931,74933,80911,88882,27649,19678,"(CONTRACTS OF 12,500,000 JAPANESE YEN)"
17/08/2004,JPY,109.84,1.36%,0.0137,-0.13,-1.85,113957,11251,16456,209,76801,72935,88261,89600,25696,24357,"(CONTRACTS OF 12,500,000 JAPANESE YEN)"
10/08/2004,JPY,111.35,-0.62%,-0.0062,-0.06,-1.73,110433,10330,18612,199,74030,67151,84559,85962,25874,24471,"(CONTRACTS OF 12,500,000 JAPANESE YEN)"
03/08/2004,JPY,110.66,0.21%,0.0021,-0.07,-1.78,113468,12133,15401,371,75397,70164,87901,85936,25567,27532,"(CONTRACTS OF 12,500,000 JAPANESE YEN)"
27/07/2004,JPY,110.89,-2.11%,-0.0209,-0.07,-1.64,107170,10608,13009,225,68332,73364,79165,86598,28005,20572,"(CONTRACTS OF 12,500,000 JAPANESE YEN)"
20/07/2004,JPY,108.6,0.01%,0.0001,-0.13,-1.65,109321,11789,9952,199,64571,84000,76559,94151,32762,15170,"(CONTRACTS OF 12,500,000 JAPANESE YEN)"
13/07/2004,JPY,108.61,0.74%,0.0074,-0.06,-1.58,106390,10569,8403,205,64336,83973,75110,92581,31280,13809,"(CONTRACTS OF 12,500,000 JAPANESE YEN)"
06/07/2004,JPY,109.42,-1.13%,-0.0112,-0.08,-1.6,99512,7488,5071,257,56796,80841,64541,86169,34971,13343,"(CONTRACTS OF 12,500,000 JAPANESE YEN)"
29/06/2004,JPY,108.2,0.92%,0.0093,-0.07,-1.61,98904,13262,4846,349,53806,80155,67417,85350,31487,13554,"(CONTRACTS OF 12,500,000 JAPANESE YEN)"
22/06/2004,JPY,109.21,0.27%,0.0027,-0.14,-1.6,92993,12433,6938,221,54160,70946,66814,78105,26179,14888,"(CONTRACTS OF 12,500,000 JAPANESE YEN)"
15/06/2004,JPY,109.51,0.13%,0.0013,-0.1,-1.57,91167,11677,9184,323,56277,64008,68277,73515,22890,17652,"(CONTRACTS OF 12,500,000 JAPANESE YEN)"
08/06/2004,JPY,109.65,0.85%,0.0085,-0.09,-1.42,126066,12259,11661,908,80681,92895,93848,105464,32218,20602,"(CONTRACTS OF 12,500,000 JAPANESE YEN)"
01/06/2004,JPY,110.59,1.06%,0.0107,-0.09,-1.3,115839,8561,13400,207,75811,81740,84579,95347,31260,20492,"(CONTRACTS OF 12,500,000 JAPANESE YEN)"
25/05/2004,JPY,111.78,2.17%,0.0219,-0.09,-1.33,107597,8656,20763,384,67210,63451,76250,84598,31347,22999,"(CONTRACTS OF 12,500,000 JAPANESE YEN)"
18/05/2004,JPY,114.26,-1.23%,-0.0122,-0.09,-1.25,105799,9095,21777,384,65786,59127,75265,81288,30534,24511,"(CONTRACTS OF 12,500,000 JAPANESE YEN)"
11/05/2004,JPY,112.87,-3.25%,-0.032,-0.09,-1.23,108604,8791,18884,383,65656,63948,74830,83215,33774,25389,"(CONTRACTS OF 12,500,000 JAPANESE YEN)"
04/05/2004,JPY,109.32,0.18%,0.0018,-0.09,-1.16,103861,12525,9552,39,59816,76749,72380,86340,31481,17521,"(CONTRACTS OF 12,500,000 JAPANESE YEN)"
27/04/2004,JPY,109.52,-0.70%,-0.007,-0.08,-1.15,104978,17240,17036,3,56938,72673,74181,89712,30797,15266,"(CONTRACTS OF 12,500,000 JAPANESE YEN)"
20/04/2004,JPY,108.76,-2.02%,-0.02,-0.08,-1.16,104240,18697,24741,3,55727,66233,74427,90977,29813,13263,"(CONTRACTS OF 12,500,000 JAPANESE YEN)"
12/04/2004,JPY,106.61,-0.84%,-0.0084,-0.09,-1.13,135388,47017,22257,3,53038,101443,100058,123703,35330,11685,"(CONTRACTS OF 12,500,000 JAPANESE YEN)"
06/04/2004,JPY,105.72,-0.06%,-0.0006,-0.09,-1.12,132851,43206,22818,3,53304,97998,96513,120819,36338,12032,"(CONTRACTS OF 12,500,000 JAPANESE YEN)"
30/03/2004,JPY,105.66,1.01%,0.0102,-0.12,-1.12,107017,26251,21942,612,49818,71283,76681,93837,30336,13180,"(CONTRACTS OF 12,500,000 JAPANESE YEN)"
23/03/2004,JPY,106.74,1.98%,0.02,-0.09,-1.1,86095,11328,25929,60,50177,44909,61565,70898,24530,15197,"(CONTRACTS OF 12,500,000 JAPANESE YEN)"
16/03/2004,JPY,108.9,2.13%,0.0215,-0.1,-1.12,89476,6974,38413,504,56694,25937,64172,64854,25304,24622,"(CONTRACTS OF 12,500,000 JAPANESE YEN)"
09/03/2004,JPY,111.27,-1.06%,-0.0106,-0.11,-1.1,156926,7779,42295,926,118435,88943,127140,132164,29786,24762,"(CONTRACTS OF 12,500,000 JAPANESE YEN)"
02/03/2004,JPY,110.1,-1.77%,-0.0176,-0.09,-1.1,153545,15719,38031,924,109142,88068,125785,127023,27760,26522,"(CONTRACTS OF 12,500,000 JAPANESE YEN)"
24/02/2004,JPY,108.18,-2.41%,-0.0239,-0.09,-1.1,142090,16202,28383,221,96978,92561,113401,121165,28689,20925,"(CONTRACTS OF 12,500,000 JAPANESE YEN)"
17/02/2004,JPY,105.63,-0.13%,-0.0013,-0.11,-1.11,159603,62030,6832,659,60003,135501,122692,142992,36911,16611,"(CONTRACTS OF 12,500,000 JAPANESE YEN)"
10/02/2004,JPY,105.49,0.01%,0.0001,-0.09,-1.13,160443,64595,5965,190,59887,135673,124672,141828,35771,18615,"(CONTRACTS OF 12,500,000 JAPANESE YEN)"
03/02/2004,JPY,105.5,0.10%,0.001,-0.09,-1.13,169516,70199,5700,199,60888,146770,131286,152669,38230,16847,"(CONTRACTS OF 12,500,000 JAPANESE YEN)"
27/01/2004,JPY,105.61,1.30%,0.0131,-0.09,-1.12,160713,63946,5954,218,57941,139191,122105,145363,38608,15350,"(CONTRACTS OF 12,500,000 JAPANESE YEN)"
20/01/2004,JPY,107,-0.76%,-0.0076,-0.08,-1.12,152326,56801,5093,297,59063,128517,116161,133907,36165,18419,"(CONTRACTS OF 12,500,000 JAPANESE YEN)"
13/01/2004,JPY,106.19,-0.01%,-0.0001,-0.06,-1.1,159233,65248,4646,147,55227,138539,120622,143332,38611,15901,"(CONTRACTS OF 12,500,000 JAPANESE YEN)"
06/01/2004,JPY,106.18,0.84%,0.0084,-0.07,-1.13,156255,62753,5919,118,53883,134417,116754,140454,39501,15801,"(CONTRACTS OF 12,500,000 JAPANESE YEN)"
30/12/2003,JPY,107.08,0.42%,0.0042,-0.08,-1.16,138423,51851,4187,92,51686,116941,103629,121220,34794,17203,"(CONTRACTS OF 12,500,000 JAPANESE YEN)"
22/12/2003,JPY,107.53,-0.03%,-0.0003,-0.11,-1.19,131080,52320,4185,25,44767,110677,97112,114887,33968,16193,"(CONTRACTS OF 12,500,000 JAPANESE YEN)"
16/12/2003,JPY,107.5,-0.54%,-0.0054,0.04,-1.05,139376,62421,4185,2,43063,118798,105486,122985,33890,16391,"(CONTRACTS OF 12,500,000 JAPANESE YEN)"
09/12/2003,JPY,106.92,1.50%,0.0151,-0.08,-1.15,170513,62513,5777,525,66696,136954,129734,143256,40779,27257,"(CONTRACTS OF 12,500,000 JAPANESE YEN)"
02/12/2003,JPY,108.55,0.74%,0.0074,-0.08,-1.15,142600,53739,7553,908,54016,114664,108663,123125,33937,19475,"(CONTRACTS OF 12,500,000 JAPANESE YEN)"
25/11/2003,JPY,109.36,-1.22%,-0.0121,-0.1,-1.14,133380,47773,5233,667,52832,107929,101272,113829,32108,19551,"(CONTRACTS OF 12,500,000 JAPANESE YEN)"
18/11/2003,JPY,108.04,0.58%,0.0058,-0.1,-1.17,143468,59678,5916,632,47691,117852,108001,124400,35467,19068,"(CONTRACTS OF 12,500,000 JAPANESE YEN)"
11/11/2003,JPY,108.67,0.77%,0.0077,-0.1,-1.16,143363,63585,5788,608,45313,115745,109506,122141,33857,21222,"(CONTRACTS OF 12,500,000 JAPANESE YEN)"
04/11/2003,JPY,109.51,-1.21%,-0.012,-0.1,-1.15,135896,56179,5835,585,48770,105901,105534,112321,30362,23575,"(CONTRACTS OF 12,500,000 JAPANESE YEN)"
28/10/2003,JPY,108.2,1.13%,0.0114,-0.08,-1.14,152880,71462,16552,82,43278,113848,114822,130482,38058,22398,"(CONTRACTS OF 12,500,000 JAPANESE YEN)"
21/10/2003,JPY,109.44,-0.52%,-0.0052,-0.08,-1.13,151390,69794,21490,53,43485,107894,113332,129437,38058,21953,"(CONTRACTS OF 12,500,000 JAPANESE YEN)"
14/10/2003,JPY,108.87,0.96%,0.0096,-0.08,-1.12,154276,71679,32470,53,43437,99358,115169,131881,39107,22395,"(CONTRACTS OF 12,500,000 JAPANESE YEN)"
07/10/2003,JPY,109.92,1.40%,0.0141,-0.09,-1.12,159009,76438,26713,29,42205,110396,118672,137138,40337,21871,"(CONTRACTS OF 12,500,000 JAPANESE YEN)"
30/09/2003,JPY,111.48,0.69%,0.007,0.03,-1,144431,69657,28792,8,38358,96148,108023,124948,36408,19483,"(CONTRACTS OF 12,500,000 JAPANESE YEN)"
23/09/2003,JPY,112.26,3.35%,0.0341,-0.1,-1.13,135500,61520,7972,0,37854,106839,99374,114811,36126,20689,"(CONTRACTS OF 12,500,000 JAPANESE YEN)"
16/09/2003,JPY,116.15,0.55%,0.0055,0.03,-1,126661,60153,5506,0,34678,105030,94831,110536,31830,16125,"(CONTRACTS OF 12,500,000 JAPANESE YEN)"
09/09/2003,JPY,116.79,-0.34%,-0.0033,-0.1,-1.14,171788,59532,6687,1549,74834,138974,135915,147210,35873,24578,"(CONTRACTS OF 12,500,000 JAPANESE YEN)"
02/09/2003,JPY,116.4,0.80%,0.008,-0.1,-1.15,169584,53464,6509,564,81558,138970,135586,146043,33998,23541,"(CONTRACTS OF 12,500,000 JAPANESE YEN)"
26/08/2003,JPY,117.34,0.85%,0.0086,-0.1,-1.11,131738,22148,8916,1797,83348,96859,107293,107572,24445,24166,"(CONTRACTS OF 12,500,000 JAPANESE YEN)"
19/08/2003,JPY,118.35,0.29%,0.003,-0.1,-1.12,118044,14557,23909,676,64180,45358,79413,69943,38631,48101,"(CONTRACTS OF 12,500,000 JAPANESE YEN)"
12/08/2003,JPY,118.7,0.89%,0.009,-0.1,-1.13,115581,12940,22880,694,87270,65228,100904,88802,14677,26779,"(CONTRACTS OF 12,500,000 JAPANESE YEN)"
05/08/2003,JPY,119.77,0.11%,0.0011,-0.11,-1.13,125420,10136,46435,250,102290,46435,112676,93120,12744,32300,"(CONTRACTS OF 12,500,000 JAPANESE YEN)"
29/07/2003,JPY,119.9,-0.68%,-0.0068,-0.11,-1.14,103252,18580,12272,334,68142,65307,87056,77913,16196,25339,"(CONTRACTS OF 12,500,000 JAPANESE YEN)"
22/07/2003,JPY,119.09,-0.98%,-0.0097,-0.11,-1.12,104161,16536,9744,62,68373,70702,84971,80508,19190,23653,"(CONTRACTS OF 12,500,000 JAPANESE YEN)"
15/07/2003,JPY,117.94,0.15%,0.0015,-0.11,-1.11,113969,23702,7877,111,67833,85119,91646,93107,22323,20862,"(CONTRACTS OF 12,500,000 JAPANESE YEN)"
08/07/2003,JPY,118.12,1.06%,0.0107,0.01,-1,104434,13642,13534,306,75970,63341,89918,77181,14516,27253,"(CONTRACTS OF 12,500,000 JAPANESE YEN)"
01/07/2003,JPY,119.39,-1.32%,-0.0131,0.01,-1,104184,8768,22165,531,79662,49337,88961,72033,15223,32151,"(CONTRACTS OF 12,500,000 JAPANESE YEN)"
24/06/2003,JPY,117.84,0.24%,0.0024,-0.07,-0.95,98292,25897,8761,788,54124,68080,80809,77629,17483,20663,"(CONTRACTS OF 12,500,000 JAPANESE YEN)"
17/06/2003,JPY,118.12,-0.35%,-0.0035,-0.02,-0.95,91916,24463,13601,653,49945,56963,75061,71217,16855,20699,"(CONTRACTS OF 12,500,000 JAPANESE YEN)"
10/06/2003,JPY,117.71,1.27%,0.0127,-0.06,-1.1,121421,22835,11079,1045,78389,73398,102269,85522,19152,35899,"(CONTRACTS OF 12,500,000 JAPANESE YEN)"
03/06/2003,JPY,119.22,-1.68%,-0.0167,-0.06,-1.23,98513,19933,12373,142,61304,56170,81379,68685,17134,29828,"(CONTRACTS OF 12,500,000 JAPANESE YEN)"
27/05/2003,JPY,117.25,-0.56%,-0.0056,-0.06,-1.26,109843,36758,7315,199,45387,76528,82344,84042,27499,25801,"(CONTRACTS OF 12,500,000 JAPANESE YEN)"
20/05/2003,JPY,116.6,0.19%,0.0019,-0.06,-1.18,111964,37884,8114,189,45972,80487,84045,88790,27919,23174,"(CONTRACTS OF 12,500,000 JAPANESE YEN)"
13/05/2003,JPY,116.82,0.57%,0.0057,-0.05,-1.23,114134,38488,9026,260,48552,82010,87300,91296,26834,22838,"(CONTRACTS OF 12,500,000 JAPANESE YEN)"
06/05/2003,JPY,117.49,1.91%,0.0193,-0.03,-1.17,99924,19853,17185,1250,58377,60299,79480,78734,20444,21190,"(CONTRACTS OF 12,500,000 JAPANESE YEN)"
29/04/2003,JPY,119.78,0.13%,0.0013,-0.02,-1.24,86346,9641,19821,134,64572,43129,74347,63084,11999,23262,"(CONTRACTS OF 12,500,000 JAPANESE YEN)"
22/04/2003,JPY,119.93,0.27%,0.0027,-0.02,-1.23,83959,14525,18708,156,58741,42580,73422,61444,10537,22515,"(CONTRACTS OF 12,500,000 JAPANESE YEN)"
15/04/2003,JPY,120.25,-0.35%,-0.0035,-0.03,-1.26,79252,9937,19354,126,59144,37337,69207,56817,10045,22435,"(CONTRACTS OF 12,500,000 JAPANESE YEN)"
08/04/2003,JPY,119.83,-1.54%,-0.0153,-0.02,-1.18,75088,11031,16665,535,53069,39519,64635,56719,10453,18369,"(CONTRACTS OF 12,500,000 JAPANESE YEN)"
01/04/2003,JPY,118.01,1.77%,0.0179,-0.03,-1.17,80136,12485,16388,56,54463,43455,67004,59899,13132,20237,"(CONTRACTS OF 12,500,000 JAPANESE YEN)"
25/03/2003,JPY,120.14,-1.10%,-0.011,-0.05,-1.25,84457,10780,23763,90,63468,36695,74338,60548,10119,23909,"(CONTRACTS OF 12,500,000 JAPANESE YEN)"
18/03/2003,JPY,118.83,-1.49%,-0.0148,-0.05,-1.22,82659,30389,7071,54,33010,58145,63453,65270,19206,17389,"(CONTRACTS OF 12,500,000 JAPANESE YEN)"
11/03/2003,JPY,117.08,0.65%,0.0066,-0.02,-1.13,133098,42400,6181,545,60724,103505,103669,110231,29429,22867,"(CONTRACTS OF 12,500,000 JAPANESE YEN)"
04/03/2003,JPY,117.85,-0.50%,-0.005,-0.02,-1.25,116621,40722,8690,480,51335,90841,92537,100011,24084,16610,"(CONTRACTS OF 12,500,000 JAPANESE YEN)"
25/02/2003,JPY,117.26,1.45%,0.0146,-0.02,-1.25,118365,45047,9293,535,51661,89891,97243,99719,21122,18646,"(CONTRACTS OF 12,500,000 JAPANESE YEN)"
18/02/2003,JPY,118.99,1.66%,0.0168,-0.05,-1.3,113853,37746,19313,168,58565,69131,96479,88612,17374,25241,"(CONTRACTS OF 12,500,000 JAPANESE YEN)"
11/02/2003,JPY,121,-1.06%,-0.0106,-0.05,-1.31,110275,30376,19667,1001,65096,59904,96473,80572,13802,29703,"(CONTRACTS OF 12,500,000 JAPANESE YEN)"
04/02/2003,JPY,119.73,-0.92%,-0.0091,0.04,-1.2,91248,19681,14087,1131,54717,52104,75529,67322,15719,23926,"(CONTRACTS OF 12,500,000 JAPANESE YEN)"
28/01/2003,JPY,118.64,-0.44%,-0.0044,-0.05,-1.29,108851,36528,10918,428,52997,79960,89953,91306,18898,17545,"(CONTRACTS OF 12,500,000 JAPANESE YEN)"
21/01/2003,JPY,118.12,-0.03%,-0.0003,-0.06,-1.3,119530,44463,11170,439,51963,88915,96865,100524,22665,19006,"(CONTRACTS OF 12,500,000 JAPANESE YEN)"
14/01/2003,JPY,118.09,1.91%,0.0193,-0.06,-1.34,120396,44399,11455,39,49339,91697,93777,103191,26619,17205,"(CONTRACTS OF 12,500,000 JAPANESE YEN)"
07/01/2003,JPY,120.39,-1.39%,-0.0138,-0.06,-1.35,116555,39488,12261,47,59421,85958,98956,98266,17599,18289,"(CONTRACTS OF 12,500,000 JAPANESE YEN)"
31/12/2002,JPY,118.74,1.39%,0.014,-0.08,-1.36,119681,40666,12532,404,56491,91282,97561,104218,22120,15463,"(CONTRACTS OF 12,500,000 JAPANESE YEN)"
23/12/2002,JPY,120.41,0.68%,0.0069,0.03,-1.35,92767,16976,13169,416,59941,59826,77333,73411,15434,19356,"(CONTRACTS OF 12,500,000 JAPANESE YEN)"
17/12/2002,JPY,121.24,2.02%,0.0204,-0.12,-1.46,87176,11832,12538,416,62454,52066,74702,65020,12474,22156,"(CONTRACTS OF 12,500,000 JAPANESE YEN)"
10/12/2002,JPY,123.74,0.64%,0.0064,0.03,-1.31,119680,8206,20416,670,99299,73325,108175,94411,11505,25269,"(CONTRACTS OF 12,500,000 JAPANESE YEN)"
03/12/2002,JPY,124.54,-2.43%,-0.0241,-0.04,-1.39,78433,9754,19657,329,57574,33578,67657,53564,10776,24869,"(CONTRACTS OF 12,500,000 JAPANESE YEN)"
26/11/2002,JPY,121.58,0.47%,0.0048,-0.06,-1.41,71861,11744,16208,332,47494,38202,59570,54742,12291,17119,"(CONTRACTS OF 12,500,000 JAPANESE YEN)"
19/11/2002,JPY,122.16,-2.08%,-0.0206,-0.08,-1.42,75092,12867,15758,1729,45771,37575,60367,55062,14725,20030,"(CONTRACTS OF 12,500,000 JAPANESE YEN)"
12/11/2002,JPY,119.67,1.77%,0.0179,-0.02,-1.36,77422,14064,14491,1400,41580,44934,57044,60825,20378,16597,"(CONTRACTS OF 12,500,000 JAPANESE YEN)"
05/11/2002,JPY,121.83,1.06%,0.0106,-0.02,-1.54,75258,12412,17108,837,48471,36954,61720,54899,13538,20359,"(CONTRACTS OF 12,500,000 JAPANESE YEN)"
29/10/2002,JPY,123.13,1.59%,0.016,0.01,-1.66,79469,13185,21449,374,52101,34902,65660,56725,13809,22744,"(CONTRACTS OF 12,500,000 JAPANESE YEN)"
22/10/2002,JPY,125.12,-0.37%,-0.0037,-0.03,-1.76,85343,8768,23702,1285,66165,30174,76218,55161,9125,30182,"(CONTRACTS OF 12,500,000 JAPANESE YEN)"
15/10/2002,JPY,124.66,-0.25%,-0.0025,-0.02,-1.72,80287,8606,21436,418,61414,31389,70438,53243,9849,27044,"(CONTRACTS OF 12,500,000 JAPANESE YEN)"
08/10/2002,JPY,124.35,-1.48%,-0.0147,-0.01,-1.66,82495,9841,23082,342,61735,31290,71918,54714,10577,27781,"(CONTRACTS OF 12,500,000 JAPANESE YEN)"
01/10/2002,JPY,122.54,0.62%,0.0062,-0.01,-1.69,71055,2586,17899,217,57426,27128,60229,45244,10826,25811,"(CONTRACTS OF 12,500,000 JAPANESE YEN)"
24/09/2002,JPY,123.3,-1.12%,-0.0111,-0.02,-1.73,70469,1826,19906,232,57516,25507,59574,45645,10895,24824,"(CONTRACTS OF 12,500,000 JAPANESE YEN)"
17/09/2002,JPY,121.94,-1.71%,-0.017,0.03,-1.7,68295,1996,18370,239,52942,27220,55177,45829,13118,22466,"(CONTRACTS OF 12,500,000 JAPANESE YEN)"
10/09/2002,JPY,119.89,-2.41%,-0.0238,-0.03,-1.76,102073,14997,11777,73,66802,74349,81872,86199,20201,15874,"(CONTRACTS OF 12,500,000 JAPANESE YEN)"
03/09/2002,JPY,117.07,0.92%,0.0093,-0.03,-1.76,77046,17853,11212,213,35999,53578,54065,65003,22981,12043,"(CONTRACTS OF 12,500,000 JAPANESE YEN)"
27/08/2002,JPY,118.16,0.58%,0.0058,-0.03,-1.76,72646,15007,10656,84,35846,50081,50937,60821,21709,11825,"(CONTRACTS OF 12,500,000 JAPANESE YEN)"
20/08/2002,JPY,118.85,-0.41%,-0.0041,-0.03,-1.72,70974,12496,9084,98,37596,49381,50190,58563,20784,12411,"(CONTRACTS OF 12,500,000 JAPANESE YEN)"
13/08/2002,JPY,118.36,2.00%,0.0202,-0.03,-1.66,70948,13237,9573,83,37857,48228,51177,57884,19771,13064,"(CONTRACTS OF 12,500,000 JAPANESE YEN)"
06/08/2002,JPY,120.77,-0.47%,-0.0047,-0.03,-1.74,71254,12340,11634,109,38603,44956,51052,56699,20202,14555,"(CONTRACTS OF 12,500,000 JAPANESE YEN)"
30/07/2002,JPY,120.2,-2.30%,-0.0227,-0.03,-1.77,73947,14452,10600,88,37369,48706,51909,59394,22038,14553,"(CONTRACTS OF 12,500,000 JAPANESE YEN)"
23/07/2002,JPY,117.5,-1.44%,-0.0143,-0.03,-1.74,76478,20262,10399,2,31525,53781,51789,64182,24689,12296,"(CONTRACTS OF 12,500,000 JAPANESE YEN)"
16/07/2002,JPY,115.83,1.89%,0.0191,-0.03,-1.8,78550,21661,10440,28,30212,54062,51901,64530,26649,14020,"(CONTRACTS OF 12,500,000 JAPANESE YEN)"
09/07/2002,JPY,118.06,1.47%,0.0148,0.03,-1.73,78069,20799,10599,27,30341,54898,51167,65524,26902,12545,"(CONTRACTS OF 12,500,000 JAPANESE YEN)"
02/07/2002,JPY,119.82,1.23%,0.0124,-0.03,-1.8,74473,19786,10740,51,29992,50095,49829,60886,24644,13587,"(CONTRACTS OF 12,500,000 JAPANESE YEN)"
25/06/2002,JPY,121.31,2.41%,0.0244,-0.02,-1.8,75487,21992,11383,44,28762,49893,50798,61320,24689,14167,"(CONTRACTS OF 12,500,000 JAPANESE YEN)"
18/06/2002,JPY,124.31,0.76%,0.0076,0.01,-1.77,68634,19424,9955,44,28499,44060,47967,54059,20667,14575,"(CONTRACTS OF 12,500,000 JAPANESE YEN)"
11/06/2002,JPY,125.26,-0.92%,-0.0091,-0.02,-1.8,105123,17774,11699,568,57985,67721,76327,79988,28796,25135,"(CONTRACTS OF 12,500,000 JAPANESE YEN)"
04/06/2002,JPY,124.12,0.34%,0.0034,-0.02,-1.81,97625,17715,9340,621,53113,71677,71449,81638,26176,15987,"(CONTRACTS OF 12,500,000 JAPANESE YEN)"
28/05/2002,JPY,124.54,-0.35%,-0.0035,-0.03,-1.83,94948,20481,8307,595,51083,70296,72159,79198,22789,15750,"(CONTRACTS OF 12,500,000 JAPANESE YEN)"
21/05/2002,JPY,124.11,3.42%,0.0348,-0.01,-1.81,95905,21800,7938,690,51295,68014,73785,76642,22120,19263,"(CONTRACTS OF 12,500,000 JAPANESE YEN)"
14/05/2002,JPY,128.5,-0.46%,-0.0046,-0.01,-1.82,83322,14583,11769,297,52229,51578,67109,63644,16213,19678,"(CONTRACTS OF 12,500,000 JAPANESE YEN)"
07/05/2002,JPY,127.91,0.45%,0.0045,-0.02,-1.78,84031,16872,10358,265,48007,56167,65144,66790,18887,17241,"(CONTRACTS OF 12,500,000 JAPANESE YEN)"
30/04/2002,JPY,128.49,1.31%,0.0132,-0.02,-1.83,82621,16757,11103,272,48250,51011,65279,62386,17342,20235,"(CONTRACTS OF 12,500,000 JAPANESE YEN)"
23/04/2002,JPY,130.2,0.73%,0.0073,-0.02,-1.85,67954,12647,13373,278,41584,36436,54509,50087,13445,17867,"(CONTRACTS OF 12,500,000 JAPANESE YEN)"
16/04/2002,JPY,131.16,-0.22%,-0.0022,0.02,-1.84,71886,8644,17395,135,53539,34725,62318,52255,9568,19631,"(CONTRACTS OF 12,500,000 JAPANESE YEN)"
09/04/2002,JPY,130.87,1.84%,0.0185,0.03,-1.84,69913,7488,18329,303,52883,33984,60674,52616,9239,17297,"(CONTRACTS OF 12,500,000 JAPANESE YEN)"
02/04/2002,JPY,133.32,-0.23%,-0.0023,-0.01,-1.93,78204,14174,23431,25,56634,33165,70833,56621,7371,21583,"(CONTRACTS OF 12,500,000 JAPANESE YEN)"
26/03/2002,JPY,133.01,-0.80%,-0.0079,0.04,-1.9,72383,12941,17301,25,48069,35276,61035,52602,11348,19781,"(CONTRACTS OF 12,500,000 JAPANESE YEN)"
19/03/2002,JPY,131.96,-2.36%,-0.0233,0.02,-1.92,71074,13812,14939,146,43504,38453,57462,53538,13612,17536,"(CONTRACTS OF 12,500,000 JAPANESE YEN)"
12/03/2002,JPY,128.92,2.44%,0.0247,0.02,-1.88,110848,20510,13612,133,68149,75511,88792,89256,22056,21592,"(CONTRACTS OF 12,500,000 JAPANESE YEN)"
05/03/2002,JPY,132.14,1.81%,0.0182,-0.01,-1.83,104976,13717,27363,319,75362,47532,89398,75214,15578,29762,"(CONTRACTS OF 12,500,000 JAPANESE YEN)"
26/02/2002,JPY,134.57,-0.73%,-0.0072,-0.01,-1.82,127692,23130,42942,734,90724,51540,114588,95216,13104,32476,"(CONTRACTS OF 12,500,000 JAPANESE YEN)"
19/02/2002,JPY,133.6,-0.69%,-0.0069,0.02,-1.79,122120,23244,35576,724,83910,53367,107878,89667,14242,32453,"(CONTRACTS OF 12,500,000 JAPANESE YEN)"
12/02/2002,JPY,132.68,0.90%,0.009,0.02,-1.78,115316,22996,30777,708,78664,51339,102368,82824,12948,32492,"(CONTRACTS OF 12,500,000 JAPANESE YEN)"
05/02/2002,JPY,133.88,-0.45%,-0.0045,0.05,-1.76,129271,31592,35608,651,85296,57277,117539,93536,11732,35735,"(CONTRACTS OF 12,500,000 JAPANESE YEN)"
29/01/2002,JPY,133.28,0.43%,0.0043,0.03,-1.74,126984,31724,38067,129,83247,53404,115100,91600,11884,35384,"(CONTRACTS OF 12,500,000 JAPANESE YEN)"
22/01/2002,JPY,133.85,-1.98%,-0.0196,-0.01,-1.73,130458,27336,41737,5,85756,46246,113097,87988,17361,42470,"(CONTRACTS OF 12,500,000 JAPANESE YEN)"
15/01/2002,JPY,131.25,1.07%,0.0108,-0.01,-1.64,133175,36543,39146,76,83608,50279,120227,89501,12948,43674,"(CONTRACTS OF 12,500,000 JAPANESE YEN)"
08/01/2002,JPY,132.67,-1.21%,-0.0121,0.04,-1.71,135340,38443,41973,8,84030,57190,122481,99171,12859,36169,"(CONTRACTS OF 12,500,000 JAPANESE YEN)"
28/12/2001,JPY,131.08,-1.24%,-0.0123,0.08,-1.68,130768,39575,38709,660,80419,55998,120654,95367,10114,35401,"(CONTRACTS OF 12,500,000 JAPANESE YEN)"
21/12/2001,JPY,129.48,-1.39%,-0.0138,0.04,-1.83,129864,37531,41852,251,83084,53221,120866,95324,8998,34540,"(CONTRACTS OF 12,500,000 JAPANESE YEN)"
18/12/2001,JPY,127.71,-1.32%,-0.0131,0.04,-1.82,126848,37020,38955,745,82669,49620,120434,89320,6414,37528,"(CONTRACTS OF 12,500,000 JAPANESE YEN)"
11/12/2001,JPY,126.05,-1.47%,-0.0146,0.02,-1.77,153340,36798,41056,25,99520,71288,136343,112369,16997,40971,"(CONTRACTS OF 12,500,000 JAPANESE YEN)"
04/12/2001,JPY,124.22,-0.25%,-0.0025,0.03,-1.78,119948,29792,38210,469,77539,50229,107800,88908,12148,31040,"(CONTRACTS OF 12,500,000 JAPANESE YEN)"
27/11/2001,JPY,123.91,-1.11%,-0.011,0.02,-1.99,109170,18647,40277,423,77600,37963,96670,78663,12500,30507,"(CONTRACTS OF 12,500,000 JAPANESE YEN)"
20/11/2001,JPY,122.55,-0.75%,-0.0075,0.02,-2.02,102491,13491,32377,332,73580,36446,87403,69155,15088,33336,"(CONTRACTS OF 12,500,000 JAPANESE YEN)"
13/11/2001,JPY,121.64,-0.40%,-0.004,0.02,-1.88,92819,19203,23434,54,62532,45595,81789,69083,11030,23736,"(CONTRACTS OF 12,500,000 JAPANESE YEN)"
06/11/2001,JPY,121.15,0.65%,0.0065,0.02,-1.92,91333,14379,28293,73,66183,36551,80635,64917,10698,26416,"(CONTRACTS OF 12,500,000 JAPANESE YEN)"
30/10/2001,JPY,121.94,0.49%,0.0049,0.02,-2.04,81807,3817,31162,62,69796,21911,73675,53135,8132,28672,"(CONTRACTS OF 12,500,000 JAPANESE YEN)"
23/10/2001,JPY,122.54,-1.06%,-0.0106,0.02,-2.26,75643,3588,25372,14,63491,21453,67093,46839,8550,28804,"(CONTRACTS OF 12,500,000 JAPANESE YEN)"
16/10/2001,JPY,121.25,-0.98%,-0.0098,0.02,-2.32,74649,15409,16523,11,48699,33312,64119,49846,10530,24803,"(CONTRACTS OF 12,500,000 JAPANESE YEN)"
09/10/2001,JPY,120.07,0.55%,0.0056,0.02,-2.32,71605,20983,10715,81,37987,42434,59051,53230,12554,18375,"(CONTRACTS OF 12,500,000 JAPANESE YEN)"
02/10/2001,JPY,120.74,-2.77%,-0.0274,0.02,-2.42,75174,22438,8929,70,38960,48884,61468,57883,13706,17291,"(CONTRACTS OF 12,500,000 JAPANESE YEN)"
25/09/2001,JPY,117.48,-0.20%,-0.002,0.02,-2.4,90169,39909,9544,48,29273,66812,69230,76404,20939,13765,"(CONTRACTS OF 12,500,000 JAPANESE YEN)"
18/09/2001,JPY,117.24,1.62%,0.0163,0.01,-2.81,86678,37787,9348,47,30738,63788,68572,73183,18106,13495,"(CONTRACTS OF 12,500,000 JAPANESE YEN)"
10/09/2001,JPY,119.17,0.06%,0.0006,0.02,-3.23,112122,32713,9220,730,53113,74036,86556,83986,25566,28136,"(CONTRACTS OF 12,500,000 JAPANESE YEN)"
04/09/2001,JPY,119.24,0.66%,0.0066,0.02,-3.4,115883,40762,8251,550,45803,85594,87115,94395,28768,21488,"(CONTRACTS OF 12,500,000 JAPANESE YEN)"
28/08/2001,JPY,120.03,-0.42%,-0.0042,0.02,-3.34,111974,40057,9877,547,45495,80293,86099,90717,25875,21257,"(CONTRACTS OF 12,500,000 JAPANESE YEN)"
21/08/2001,JPY,119.53,1.82%,0.0183,0.02,-3.41,109786,40409,9798,548,55646,93793,96603,104139,13183,5647,"(CONTRACTS OF 12,500,000 JAPANESE YEN)"
14/08/2001,JPY,121.74,1.51%,0.0152,0.03,-3.4,101855,26620,15062,950,62214,73864,89784,89876,12071,11979,"(CONTRACTS OF 12,500,000 JAPANESE YEN)"
07/08/2001,JPY,123.61,1.14%,0.0114,0.03,-3.54,105044,26803,25375,434,62004,52509,89241,78318,15803,26726,"(CONTRACTS OF 12,500,000 JAPANESE YEN)"
31/07/2001,JPY,125.03,-0.82%,-0.0082,0.03,-3.58,105945,26464,30899,38,66721,46118,93223,77055,12722,28890,"(CONTRACTS OF 12,500,000 JAPANESE YEN)"
24/07/2001,JPY,124.01,0.66%,0.0066,0.02,-3.6,100240,26014,27243,16,62095,43940,88125,71199,12115,29041,"(CONTRACTS OF 12,500,000 JAPANESE YEN)"
17/07/2001,JPY,124.83,0.38%,0.0038,0.02,-3.61,102545,26985,36939,16,63962,35182,90963,72137,11582,30408,"(CONTRACTS OF 12,500,000 JAPANESE YEN)"
10/07/2001,JPY,125.3,-0.74%,-0.0074,0.02,-3.67,95443,17020,41110,16,65964,23490,83000,64616,12443,30827,"(CONTRACTS OF 12,500,000 JAPANESE YEN)"
03/07/2001,JPY,124.38,-0.48%,-0.0048,0.01,-3.81,72009,2294,34674,16,59361,9138,61671,43828,10338,28181,"(CONTRACTS OF 12,500,000 JAPANESE YEN)"
26/06/2001,JPY,123.79,-0.81%,-0.0081,0.01,-3.65,62444,2708,27294,20,49900,8559,52628,35873,9816,26571,"(CONTRACTS OF 12,500,000 JAPANESE YEN)"
19/06/2001,JPY,122.79,-0.96%,-0.0096,0.01,-3.63,56263,4703,20569,3,42787,11700,47493,32272,8770,23991,"(CONTRACTS OF 12,500,000 JAPANESE YEN)"
12/06/2001,JPY,121.62,-1.16%,-0.0116,0.01,-3.8,97354,16507,13792,1801,61207,56349,79515,71942,17839,25412,"(CONTRACTS OF 12,500,000 JAPANESE YEN)"
05/06/2001,JPY,120.22,-0.07%,-0.0007,0.01,-3.8,93638,16370,11107,1033,58896,64360,76299,76500,17339,17138,"(CONTRACTS OF 12,500,000 JAPANESE YEN)"
29/05/2001,JPY,120.14,2.19%,0.0221,0.01,-3.89,87280,6661,16825,1141,65411,53133,73213,71099,14067,16181,"(CONTRACTS OF 12,500,000 JAPANESE YEN)"
22/05/2001,JPY,122.83,0.41%,0.0041,0.02,-3.89,97736,2531,29579,191,74319,33995,77041,63765,20695,33971,"(CONTRACTS OF 12,500,000 JAPANESE YEN)"
15/05/2001,JPY,123.33,-1.77%,-0.0176,0.02,-3.92,92328,26429,28744,219,55737,39129,82385,68092,9943,24236,"(CONTRACTS OF 12,500,000 JAPANESE YEN)"
08/05/2001,JPY,121.18,0.66%,0.0066,0.03,-3.91,90252,26696,29615,379,52044,39857,79119,69851,11133,20401,"(CONTRACTS OF 12,500,000 JAPANESE YEN)"
01/05/2001,JPY,121.98,0.21%,0.0021,0.03,-4.15,86456,21103,26816,114,53583,37402,74800,64332,11656,22124,"(CONTRACTS OF 12,500,000 JAPANESE YEN)"
24/04/2001,JPY,122.24,0.82%,0.0082,0.04,-4.2,87870,3775,27235,40,73978,37526,77793,64801,10077,23069,"(CONTRACTS OF 12,500,000 JAPANESE YEN)"
17/04/2001,JPY,123.25,0.87%,0.0087,0.06,-4.6,90864,2292,27878,240,77384,32608,79916,60726,10948,30138,"(CONTRACTS OF 12,500,000 JAPANESE YEN)"
10/04/2001,JPY,124.33,0.94%,0.0094,0.07,-4.61,105515,34121,32200,0,61076,41424,95197,73624,10318,31891,"(CONTRACTS OF 12,500,000 JAPANESE YEN)"
03/04/2001,JPY,125.51,-2.77%,-0.0273,0.12,-4.66,106688,34750,32999,0,60655,42649,95405,75648,11283,31040,"(CONTRACTS OF 12,500,000 JAPANESE YEN)"
27/03/2001,JPY,122.13,0.08%,0.0008,0.1,-4.7,99717,33952,30465,0,54155,38713,88107,69178,11610,30539,"(CONTRACTS OF 12,500,000 JAPANESE YEN)"
20/03/2001,JPY,122.23,-2.12%,-0.021,0.1,-4.68,103349,36675,37256,0,57012,33016,93687,70272,9662,33077,"(CONTRACTS OF 12,500,000 JAPANESE YEN)"
13/03/2001,JPY,119.69,-0.70%,-0.007,0.11,-4.76,123971,23034,41341,455,88319,49978,111808,91774,12163,32197,"(CONTRACTS OF 12,500,000 JAPANESE YEN)"
06/03/2001,JPY,118.86,-2.37%,-0.0234,0.19,-4.83,98574,922,32429,165,86148,34559,87235,67153,11339,31421,"(CONTRACTS OF 12,500,000 JAPANESE YEN)"
27/02/2001,JPY,116.11,-0.41%,-0.0041,0.36,-4.59,89216,849,28386,41,77052,35884,77942,64311,11274,24905,"(CONTRACTS OF 12,500,000 JAPANESE YEN)"
20/02/2001,JPY,115.64,0.88%,0.0089,0.32,-4.98,89673,682,27742,44,78101,36748,78827,64534,10846,25139,"(CONTRACTS OF 12,500,000 JAPANESE YEN)"
13/02/2001,JPY,116.67,-1.71%,-0.0169,0.35,-4.96,90964,1484,28958,44,77697,35840,79225,64842,11739,26122,"(CONTRACTS OF 12,500,000 JAPANESE YEN)"
06/02/2001,JPY,114.71,0.99%,0.01,0.38,-4.97,92632,1829,27865,289,77974,39078,80092,67232,12540,25400,"(CONTRACTS OF 12,500,000 JAPANESE YEN)"
30/01/2001,JPY,115.86,0.95%,0.0095,0.42,-5,87420,1606,26806,33,73989,34112,75628,60951,11792,26469,"(CONTRACTS OF 12,500,000 JAPANESE YEN)"
23/01/2001,JPY,116.97,0.58%,0.0058,0.34,-5.17,91368,4611,33823,34,76864,29273,81509,63130,9859,28238,"(CONTRACTS OF 12,500,000 JAPANESE YEN)"
16/01/2001,JPY,117.65,-0.74%,-0.0074,0.41,-5.28,90061,1877,35747,687,76620,25613,79184,62047,10877,28014,"(CONTRACTS OF 12,500,000 JAPANESE YEN)"
09/01/2001,JPY,116.78,-2.04%,-0.0202,0.35,-5.16,91091,1550,41688,24,80969,21214,82543,62926,8548,28165,"(CONTRACTS OF 12,500,000 JAPANESE YEN)"
02/01/2001,JPY,114.45,-0.77%,-0.0076,0.53,-5.64,91258,1613,43032,6,81618,20802,83237,63840,8021,27418,"(CONTRACTS OF 12,500,000 JAPANESE YEN)"
26/12/2000,JPY,113.58,-1.09%,-0.0109,0.52,-5.82,90803,1634,44254,0,80867,19456,82501,63710,8302,27093,"(CONTRACTS OF 12,500,000 JAPANESE YEN)"
19/12/2000,JPY,112.35,-0.84%,-0.0084,0.53,-5.88,87563,788,39021,450,78480,19707,79718,59178,7845,28385,"(CONTRACTS OF 12,500,000 JAPANESE YEN)"
12/12/2000,JPY,111.41,-0.28%,-0.0028,0.59,-5.88,130047,110,41806,5405,113569,49976,119084,97187,10963,32860,"(CONTRACTS OF 12,500,000 JAPANESE YEN)"
05/12/2000,JPY,111.1,-0.93%,-0.0092,0.52,-6.02,82427,853,33302,20,71383,18995,72256,52317,10171,30110,"(CONTRACTS OF 12,500,000 JAPANESE YEN)"
28/11/2000,JPY,110.08,0.10%,0.001,0.51,-6.17,77425,866,34196,15,65953,17140,66834,51351,10591,26074,"(CONTRACTS OF 12,500,000 JAPANESE YEN)"
21/11/2000,JPY,110.19,-1.89%,-0.0187,0.52,-6.14,77499,986,36058,15,66966,15544,67967,51617,9532,25882,"(CONTRACTS OF 12,500,000 JAPANESE YEN)"
14/11/2000,JPY,108.15,-1.13%,-0.0113,0.53,-6.12,59507,1315,23885,15,46929,15224,48259,39124,11248,20383,"(CONTRACTS OF 12,500,000 JAPANESE YEN)"
07/11/2000,JPY,106.94,1.85%,0.0187,0.48,-6.18,59077,615,24492,35,46917,17473,47567,42000,11510,17077,"(CONTRACTS OF 12,500,000 JAPANESE YEN)"
31/10/2000,JPY,108.96,-1.19%,-0.0118,0.46,-6.19,68898,1147,28226,15,57576,14207,58738,42448,10160,26450,"(CONTRACTS OF 12,500,000 JAPANESE YEN)"
24/10/2000,JPY,107.68,0.29%,0.0029,0.46,-6.18,65348,981,28792,27,53710,12067,54718,40886,10630,24462,"(CONTRACTS OF 12,500,000 JAPANESE YEN)"
17/10/2000,JPY,107.99,-0.26%,-0.0026,0.46,-6.15,65298,965,30292,57,55031,10631,56053,40980,9245,24318,"(CONTRACTS OF 12,500,000 JAPANESE YEN)"
10/10/2000,JPY,107.71,1.00%,0.0101,0.4,-6.26,66105,977,31065,42,54026,12019,55045,43126,11060,22979,"(CONTRACTS OF 12,500,000 JAPANESE YEN)"
03/10/2000,JPY,108.8,-1.16%,-0.0116,0.51,-6.2,54499,2244,16011,680,39774,13557,42698,30248,11801,24251,"(CONTRACTS OF 12,500,000 JAPANESE YEN)"
26/09/2000,JPY,107.55,-0.54%,-0.0054,0.36,-6.19,43973,5306,9532,0,28815,14400,34121,23932,9852,20041,"(CONTRACTS OF 12,500,000 JAPANESE YEN)"
19/09/2000,JPY,106.97,-0.17%,-0.0017,0.35,-6.23,38431,3734,7566,0,22851,15713,26585,23279,11846,15152,"(CONTRACTS OF 12,500,000 JAPANESE YEN)"
12/09/2000,JPY,106.79,-0.95%,-0.0094,0.36,-6.24,92390,14416,8082,9035,50447,56710,73898,73827,18492,18563,"(CONTRACTS OF 12,500,000 JAPANESE YEN)"
05/09/2000,JPY,105.79,0.23%,0.0023,0.34,-6.25,71820,5476,12578,1264,45378,41178,52118,55020,19702,16800,"(CONTRACTS OF 12,500,000 JAPANESE YEN)"
29/08/2000,JPY,106.03,2.08%,0.021,0.37,-6.21,77923,6943,19918,1153,52015,38251,60111,59322,17812,18601,"(CONTRACTS OF 12,500,000 JAPANESE YEN)"
22/08/2000,JPY,108.28,0.68%,0.0068,0.33,-6.27,80631,140,28619,65,68875,28878,69080,57562,11551,23069,"(CONTRACTS OF 12,500,000 JAPANESE YEN)"
15/08/2000,JPY,109.02,-0.37%,-0.0037,0.31,-6.25,82088,0,28804,50,70287,29203,70337,58057,11751,24031,"(CONTRACTS OF 12,500,000 JAPANESE YEN)"
08/08/2000,JPY,108.62,0.57%,0.0057,0.16,-6.41,76872,471,27223,60,65854,25987,66385,53270,10487,23602,"(CONTRACTS OF 12,500,000 JAPANESE YEN)"
01/08/2000,JPY,109.24,-0.16%,-0.0016,0.17,-6.46,77862,1503,26502,25,64057,25073,65585,51600,12277,26262,"(CONTRACTS OF 12,500,000 JAPANESE YEN)"
25/07/2000,JPY,109.07,-0.92%,-0.0091,0.08,-6.55,69716,435,22664,25,58336,20722,58796,43411,10920,26305,"(CONTRACTS OF 12,500,000 JAPANESE YEN)"
18/07/2000,JPY,108.08,-0.96%,-0.0096,0.18,-6.47,61744,641,15127,5,50288,21961,50934,37093,10810,24651,"(CONTRACTS OF 12,500,000 JAPANESE YEN)"
11/07/2000,JPY,107.05,-0.92%,-0.0092,0.27,-6.36,52399,963,8752,5,40271,24513,41239,33270,11160,19129,"(CONTRACTS OF 12,500,000 JAPANESE YEN)"
05/07/2000,JPY,106.07,-0.73%,-0.0073,0.24,-6.41,48751,3823,9893,5,30035,20002,33863,29900,14888,18851,"(CONTRACTS OF 12,500,000 JAPANESE YEN)"
27/06/2000,JPY,105.3,0.22%,0.0022,0.04,-6.63,46786,8251,6610,33,21732,25966,30016,32609,16770,14177,"(CONTRACTS OF 12,500,000 JAPANESE YEN)"
20/06/2000,JPY,105.53,1.26%,0.0127,0.1,-6.58,40067,818,8590,0,22595,16312,23413,24902,16654,15165,"(CONTRACTS OF 12,500,000 JAPANESE YEN)"
13/06/2000,JPY,106.88,-1.05%,-0.0104,0.08,-6.67,79632,1619,11557,0,67424,52127,69043,63684,10589,15948,"(CONTRACTS OF 12,500,000 JAPANESE YEN)"
06/06/2000,JPY,105.77,0.69%,0.0069,0.08,-6.62,82045,1333,16143,9,54061,41169,55403,57321,26642,24724,"(CONTRACTS OF 12,500,000 JAPANESE YEN)"
30/05/2000,JPY,106.5,-0.08%,-0.0008,0.06,-6.76,78630,763,13228,19,60433,42319,61215,55566,17415,23064,"(CONTRACTS OF 12,500,000 JAPANESE YEN)"
23/05/2000,JPY,106.41,2.91%,0.0295,0.03,-6.74,79554,752,13931,34,63254,41599,64040,55564,15514,23990,"(CONTRACTS OF 12,500,000 JAPANESE YEN)"
16/05/2000,JPY,109.6,-0.37%,-0.0037,0.04,-6.92,82902,761,18143,349,69285,34520,70395,53012,12507,29890,"(CONTRACTS OF 12,500,000 JAPANESE YEN)"
09/05/2000,JPY,109.2,-0.74%,-0.0074,0.06,-6.59,80715,1523,21199,57,68032,37991,69612,59247,11103,21468,"(CONTRACTS OF 12,500,000 JAPANESE YEN)"
02/05/2000,JPY,108.4,-1.98%,-0.0196,0.04,-6.48,80159,4110,16960,78,64261,42370,68449,59408,11710,20751,"(CONTRACTS OF 12,500,000 JAPANESE YEN)"
25/04/2000,JPY,106.3,-1.55%,-0.0154,0.04,-6.18,75039,12254,8681,123,44945,51583,57322,60387,17717,14652,"(CONTRACTS OF 12,500,000 JAPANESE YEN)"
18/04/2000,JPY,104.68,2.06%,0.0208,0.04,-6.13,75075,13424,7810,81,42635,53260,56140,61151,18935,13924,"(CONTRACTS OF 12,500,000 JAPANESE YEN)"
11/04/2000,JPY,106.88,-1.60%,-0.0158,0.13,-6.09,72067,12042,8116,122,43447,50403,55611,58641,16456,13426,"(CONTRACTS OF 12,500,000 JAPANESE YEN)"
04/04/2000,JPY,105.2,0.56%,0.0056,0.09,-6.13,76692,15319,8004,120,41120,56166,56559,64290,20133,12402,"(CONTRACTS OF 12,500,000 JAPANESE YEN)"
28/03/2000,JPY,105.79,0.99%,0.01,0.07,-6.12,69382,6061,28150,94,50384,25287,56539,53531,12843,15851,"(CONTRACTS OF 12,500,000 JAPANESE YEN)"
21/03/2000,JPY,106.85,-1.57%,-0.0156,0.1,-6.06,68331,4444,28415,495,50192,23723,55131,52633,13200,15698,"(CONTRACTS OF 12,500,000 JAPANESE YEN)"
14/03/2000,JPY,105.2,0.82%,0.0082,0.07,-6.06,71233,10306,28706,400,46886,24874,57592,53980,13641,17253,"(CONTRACTS OF 12,500,000 JAPANESE YEN)"
07/03/2000,JPY,106.07,3.74%,0.0381,0.14,-5.91,127634,18522,32210,1096,94053,74531,113671,107837,13963,19797,"(CONTRACTS OF 12,500,000 JAPANESE YEN)"
29/02/2000,JPY,110.19,0.57%,0.0057,0.03,-6.02,126995,15979,61373,472,101891,39442,118342,101287,8653,25708,"(CONTRACTS OF 12,500,000 JAPANESE YEN)"
22/02/2000,JPY,110.82,-1.52%,-0.0151,0.1,-5.9,130314,15592,65948,400,103845,37588,119837,103936,10477,26378,"(CONTRACTS OF 12,500,000 JAPANESE YEN)"
15/02/2000,JPY,109.16,0.30%,0.003,0.09,-5.87,127294,15845,63670,383,103311,37305,119539,101358,7755,25936,"(CONTRACTS OF 12,500,000 JAPANESE YEN)"
08/02/2000,JPY,109.49,-1.58%,-0.0156,0.04,-6.01,122393,15452,58730,177,99718,36948,115347,95855,7046,26538,"(CONTRACTS OF 12,500,000 JAPANESE YEN)"
01/02/2000,JPY,107.79,-1.72%,-0.017,0.09,-5.96,114608,14920,52037,141,92469,35757,107530,87935,7078,26673,"(CONTRACTS OF 12,500,000 JAPANESE YEN)"
25/01/2000,JPY,105.97,-0.30%,-0.003,0.07,-5.89,102097,14395,38173,169,75880,38303,90444,76645,11653,25452,"(CONTRACTS OF 12,500,000 JAPANESE YEN)"
18/01/2000,JPY,105.65,0.40%,0.004,0.1,-5.89,98948,14552,39383,292,74679,34494,89523,74169,9425,24779,"(CONTRACTS OF 12,500,000 JAPANESE YEN)"
11/01/2000,JPY,106.07,-2.73%,-0.0269,0.13,-5.75,96868,13901,36654,232,73597,37278,87730,74164,9138,22704,"(CONTRACTS OF 12,500,000 JAPANESE YEN)"
04/01/2000,JPY,103.25,-0.88%,-0.0088,0.06,-5.99,74372,23597,8122,699,34206,49640,58502,58461,15870,15911,"(CONTRACTS OF 12,500,000 JAPANESE YEN)"
28/12/1999,JPY,102.35,-0.22%,-0.0022,0.5,-5.5,73726,26450,9454,990,31153,51444,58593,61888,15133,11838,"(CONTRACTS OF 12,500,000 JAPANESE YEN)"
21/12/1999,JPY,102.13,1.30%,0.013,0.2,-6,73528,23487,9737,990,31365,50754,55842,61481,17686,12047,"(CONTRACTS OF 12,500,000 JAPANESE YEN)"
14/12/1999,JPY,103.47,-1.07%,-0.0107,0.14,-5.96,70377,19012,9346,950,33178,47844,53140,58140,17237,12237,"(CONTRACTS OF 12,500,000 JAPANESE YEN)"
07/12/1999,JPY,102.37,-0.24%,-0.0024,0.18,-5.9,107366,41687,11362,1544,41522,79007,84753,91913,22613,15453,"(CONTRACTS OF 12,500,000 JAPANESE YEN)"
30/11/1999,JPY,102.12,2.14%,0.0216,0.16,-5.87,99716,49438,11458,806,26714,72150,76958,84414,22758,15302,"(CONTRACTS OF 12,500,000 JAPANESE YEN)"
23/11/1999,JPY,104.35,1.44%,0.0145,0.22,-5.78,90091,38048,11337,639,32035,63368,70722,75344,19369,14747,"(CONTRACTS OF 12,500,000 JAPANESE YEN)"
16/11/1999,JPY,105.87,-0.95%,-0.0095,0.23,-5.79,84939,31649,16651,392,36621,51482,68662,68525,16277,16414,"(CONTRACTS OF 12,500,000 JAPANESE YEN)"
09/11/1999,JPY,104.87,-0.65%,-0.0065,0.22,-5.74,85455,32008,12856,862,34831,55979,67701,69697,17754,15758,"(CONTRACTS OF 12,500,000 JAPANESE YEN)"
02/11/1999,JPY,104.19,0.59%,0.0059,0.06,-6.04,87789,38605,10798,1216,27394,61801,67215,73815,20574,13974,"(CONTRACTS OF 12,500,000 JAPANESE YEN)"
26/10/1999,JPY,104.81,0.52%,0.0052,0.13,-6.04,84344,39061,11348,432,24156,59427,63649,71207,20695,13137,"(CONTRACTS OF 12,500,000 JAPANESE YEN)"
19/10/1999,JPY,105.36,0.70%,0.007,0.14,-5.98,84001,39262,15884,806,23171,54137,63239,70827,20762,13174,"(CONTRACTS OF 12,500,000 JAPANESE YEN)"
12/10/1999,JPY,106.1,0.20%,0.002,0.12,-6.01,80770,37387,10217,796,21956,56720,60139,67733,20631,13037,"(CONTRACTS OF 12,500,000 JAPANESE YEN)"
05/10/1999,JPY,106.31,0.16%,0.0016,0.07,-6.01,79913,36745,10151,539,21601,57095,58885,67785,21028,12128,"(CONTRACTS OF 12,500,000 JAPANESE YEN)"
28/09/1999,JPY,106.48,-1.60%,-0.0159,0.02,-5.33,81131,40370,9085,1011,18549,57424,59930,67520,21201,13611,"(CONTRACTS OF 12,500,000 JAPANESE YEN)"
21/09/1999,JPY,104.8,0.99%,0.01,0.01,-5.44,86942,45832,8933,528,17679,65054,64039,74515,22903,12427,"(CONTRACTS OF 12,500,000 JAPANESE YEN)"
14/09/1999,JPY,105.85,4.42%,0.0453,0.03,-5.42,93219,54045,12921,720,15959,65244,70724,78885,22495,14334,"(CONTRACTS OF 12,500,000 JAPANESE YEN)"
07/09/1999,JPY,110.75,-0.96%,-0.0095,0.04,-5.38,154886,58185,13552,1621,65701,118058,125507,133231,29379,21655,"(CONTRACTS OF 12,500,000 JAPANESE YEN)"
31/08/1999,JPY,109.7,1.11%,0.0112,0.05,-5.39,146870,67229,13327,1006,53367,115529,121602,129862,25268,17008,"(CONTRACTS OF 12,500,000 JAPANESE YEN)"
24/08/1999,JPY,110.93,2.57%,0.0261,0.05,-5.4,139656,59178,14747,852,55836,107394,115866,122993,23790,16663,"(CONTRACTS OF 12,500,000 JAPANESE YEN)"
17/08/1999,JPY,113.86,0.81%,0.0081,0.01,-5.4,136057,56001,14689,876,54652,104080,111529,119645,24528,16412,"(CONTRACTS OF 12,500,000 JAPANESE YEN)"
10/08/1999,JPY,114.79,0.46%,0.0046,0.06,-5.36,132678,56618,16541,890,50009,99379,107517,116810,25161,15868,"(CONTRACTS OF 12,500,000 JAPANESE YEN)"
03/08/1999,JPY,115.32,0.96%,0.0097,0.04,-5.25,131570,56565,14696,490,49623,99848,106678,115034,24892,16536,"(CONTRACTS OF 12,500,000 JAPANESE YEN)"
27/07/1999,JPY,116.44,2.09%,0.0211,0.02,-5.26,130673,49571,24810,936,55166,85819,105673,111565,25000,19108,"(CONTRACTS OF 12,500,000 JAPANESE YEN)"
20/07/1999,JPY,118.92,1.91%,0.0192,0.02,-5.19,115699,31756,34466,849,67218,66147,99823,101462,15876,14237,"(CONTRACTS OF 12,500,000 JAPANESE YEN)"
13/07/1999,JPY,121.23,0.67%,0.0067,0.02,-5.19,113708,5766,58964,912,96973,34856,103651,94732,10057,18976,"(CONTRACTS OF 12,500,000 JAPANESE YEN)"
06/07/1999,JPY,122.05,-0.91%,-0.0091,0.03,-5.18,111634,4061,54037,743,97427,35117,102231,89897,9403,21737,"(CONTRACTS OF 12,500,000 JAPANESE YEN)"
29/06/1999,JPY,120.95,0.58%,0.0058,0.02,-5.17,108234,3561,52628,1093,92536,34488,97190,88209,11044,20025,"(CONTRACTS OF 12,500,000 JAPANESE YEN)"
22/06/1999,JPY,121.65,-1.05%,-0.0105,0.02,-5.11,104052,2178,53021,273,91990,33723,94441,87017,9611,17035,"(CONTRACTS OF 12,500,000 JAPANESE YEN)"
15/06/1999,JPY,120.38,-1.03%,-0.0103,0.02,-5.1,96356,2457,42518,1339,75838,34085,79634,77942,16722,18414,"(CONTRACTS OF 12,500,000 JAPANESE YEN)"
08/06/1999,JPY,119.15,1.28%,0.0129,0.03,-5,146342,4801,53803,2683,119962,65972,127446,122458,18896,23884,"(CONTRACTS OF 12,500,000 JAPANESE YEN)"
01/06/1999,JPY,120.7,1.29%,0.013,0.03,-4.95,118114,3868,49791,2107,98953,39620,104928,91518,13186,26596,"(CONTRACTS OF 12,500,000 JAPANESE YEN)"
25/05/1999,JPY,122.28,0.78%,0.0078,0.03,-4.9,131754,1827,64011,1210,114397,34369,117434,99590,14320,32164,"(CONTRACTS OF 12,500,000 JAPANESE YEN)"
18/05/1999,JPY,123.24,-1.92%,-0.019,0.03,-4.91,136084,3018,69715,1946,120244,32883,125208,104544,10876,31540,"(CONTRACTS OF 12,500,000 JAPANESE YEN)"
11/05/1999,JPY,120.92,-0.12%,-0.0012,0.03,-4.84,102147,2406,46471,1382,89100,30485,92888,78338,9259,23809,"(CONTRACTS OF 12,500,000 JAPANESE YEN)"
04/05/1999,JPY,120.77,-0.42%,-0.0042,0.07,-4.8,99590,5370,43808,1382,86445,28716,93197,73906,6393,25684,"(CONTRACTS OF 12,500,000 JAPANESE YEN)"
27/04/1999,JPY,120.26,-1.12%,-0.0111,0.06,-4.8,94472,2906,38216,1423,80259,29409,84588,69048,9884,25424,"(CONTRACTS OF 12,500,000 JAPANESE YEN)"
20/04/1999,JPY,118.93,0.65%,0.0065,0.07,-4.87,85666,3212,28889,1661,66648,30458,71521,61008,14145,24658,"(CONTRACTS OF 12,500,000 JAPANESE YEN)"
13/04/1999,JPY,119.71,0.76%,0.0077,0.07,-4.87,83908,2089,38468,1566,70764,20128,74419,60162,9489,23746,"(CONTRACTS OF 12,500,000 JAPANESE YEN)"
06/04/1999,JPY,120.63,-0.25%,-0.0025,0.09,-4.78,85436,1738,37435,1522,74516,21987,77776,60944,7660,24492,"(CONTRACTS OF 12,500,000 JAPANESE YEN)"
30/03/1999,JPY,120.33,-1.76%,-0.0174,0.1,-4.84,85280,2526,40989,500,74564,20234,77590,61723,7690,23557,"(CONTRACTS OF 12,500,000 JAPANESE YEN)"
23/03/1999,JPY,118.25,-0.57%,-0.0057,0.08,-4.79,74634,2128,33858,500,62417,20070,65045,54428,9589,20206,"(CONTRACTS OF 12,500,000 JAPANESE YEN)"
16/03/1999,JPY,117.58,2.83%,0.0287,0.09,-4.8,74429,1878,33670,522,64147,18285,66547,52477,7882,21952,"(CONTRACTS OF 12,500,000 JAPANESE YEN)"
09/03/1999,JPY,121,-0.75%,-0.0075,0.12,-4.76,124605,1305,45563,1542,108901,47219,111748,94324,12857,30281,"(CONTRACTS OF 12,500,000 JAPANESE YEN)"
02/03/1999,JPY,120.1,0.60%,0.006,0.13,-4.81,97584,2536,38747,976,83881,30621,87393,70344,10191,27240,"(CONTRACTS OF 12,500,000 JAPANESE YEN)"
23/02/1999,JPY,120.82,-1.84%,-0.0182,0.11,-4.76,89085,1484,35774,976,76879,27812,79339,64562,9746,24523,"(CONTRACTS OF 12,500,000 JAPANESE YEN)"
16/02/1999,JPY,118.64,-4.00%,-0.0392,0.15,-4.74,72244,7162,18278,1942,49317,31114,58421,51334,13823,20910,"(CONTRACTS OF 12,500,000 JAPANESE YEN)"
09/02/1999,JPY,114.08,-1.77%,-0.0175,0.12,-4.79,76418,18241,12052,1009,43806,47399,63056,60460,13362,15958,"(CONTRACTS OF 12,500,000 JAPANESE YEN)"
02/02/1999,JPY,112.1,1.45%,0.0146,0.12,-4.79,78317,19197,13093,1009,42246,47001,62452,61103,15865,17214,"(CONTRACTS OF 12,500,000 JAPANESE YEN)"
26/01/1999,JPY,113.75,-0.31%,-0.0031,0.25,-4.59,78063,23152,14584,533,36386,48368,60071,63485,17992,14578,"(CONTRACTS OF 12,500,000 JAPANESE YEN)"
19/01/1999,JPY,113.4,-0.93%,-0.0093,0.17,-4.66,78621,23579,18588,711,33931,45880,58221,65179,20400,13442,"(CONTRACTS OF 12,500,000 JAPANESE YEN)"
12/01/1999,JPY,112.35,-0.85%,-0.0085,0.2,-4.74,80474,28236,11310,579,28249,52201,57064,64090,23410,16384,"(CONTRACTS OF 12,500,000 JAPANESE YEN)"
05/01/1999,JPY,111.4,3.50%,0.0356,0.16,-4.77,78909,32885,10865,554,23349,52995,56788,64414,22121,14495,"(CONTRACTS OF 12,500,000 JAPANESE YEN)"
29/12/1998,JPY,115.44,0.95%,0.0096,0.37,-4.81,66189,20963,11086,533,27840,40946,49336,52565,16853,13624,"(CONTRACTS OF 12,500,000 JAPANESE YEN)"
22/12/1998,JPY,116.55,0.07%,0.0007,0.28,-4.84,65463,19626,11716,533,27894,37343,48053,49592,17410,15871,"(CONTRACTS OF 12,500,000 JAPANESE YEN)"
15/12/1998,JPY,116.63,2.08%,0.021,0.06,-5.16,65543,19442,11276,533,25717,35466,45692,47275,19851,18268,"(CONTRACTS OF 12,500,000 JAPANESE YEN)"
08/12/1998,JPY,119.11,2.42%,0.0245,0.21,-4.94,89427,14593,12298,0,60681,60916,75274,73214,14153,16213,"(CONTRACTS OF 12,500,000 JAPANESE YEN)"
01/12/1998,JPY,122.07,-0.80%,-0.008,0.06,-5.19,84057,12301,14537,30,58566,50971,70897,65538,13160,18519,"(CONTRACTS OF 12,500,000 JAPANESE YEN)"
24/11/1998,JPY,121.1,-0.05%,-0.0005,0.68,-4.54,85183,16515,15586,44,57686,53200,74245,68830,10938,16353,"(CONTRACTS OF 12,500,000 JAPANESE YEN)"
17/11/1998,JPY,121.04,0.99%,0.0099,0.68,-4.5,86640,18248,15688,0,55599,54071,73847,69759,12793,16881,"(CONTRACTS OF 12,500,000 JAPANESE YEN)"
10/11/1998,JPY,122.25,-6.09%,-0.0591,0.68,-4.63,95327,16585,15512,0,60587,57643,77172,73155,18155,22172,"(CONTRACTS OF 12,500,000 JAPANESE YEN)"
03/11/1998,JPY,115.23,2.28%,0.0231,0.75,-4.54,89560,25093,16388,0,45258,55321,70351,71709,19209,17851,"(CONTRACTS OF 12,500,000 JAPANESE YEN)"
27/10/1998,JPY,117.92,-1.24%,-0.0123,0.72,-4.43,87791,22729,18239,55,46460,53199,69244,71493,18547,16298,"(CONTRACTS OF 12,500,000 JAPANESE YEN)"
20/10/1998,JPY,116.48,1.95%,0.0197,0.69,-4.43,89791,25243,17023,250,46452,53705,71945,70978,17846,18813,"(CONTRACTS OF 12,500,000 JAPANESE YEN)"
13/10/1998,JPY,118.8,8.60%,0.0899,0.75,-4.56,88116,22889,16640,32,45098,51176,68019,67848,20097,20268,"(CONTRACTS OF 12,500,000 JAPANESE YEN)"
06/10/1998,JPY,129.98,3.27%,0.0332,0.65,-4.57,89771,28162,20336,39,42510,52838,70711,73213,19060,16558,"(CONTRACTS OF 12,500,000 JAPANESE YEN)"
29/09/1998,JPY,134.37,0.81%,0.0082,0.21,-5.04,84359,19307,18445,39,46538,49022,65884,67506,18475,16853,"(CONTRACTS OF 12,500,000 JAPANESE YEN)"
22/09/1998,JPY,135.47,-1.08%,-0.0108,0.07,-5.3,77894,18703,16640,39,40931,44979,59673,61658,18221,16236,"(CONTRACTS OF 12,500,000 JAPANESE YEN)"
15/09/1998,JPY,134.02,-1.47%,-0.0146,0.18,-5.2,79793,21708,15885,39,36461,45846,58208,61770,21585,18023,"(CONTRACTS OF 12,500,000 JAPANESE YEN)"
08/09/1998,JPY,132.08,3.34%,0.034,0.35,-5.11,138490,25433,17003,348,88417,94241,114198,111592,24292,26898,"(CONTRACTS OF 12,500,000 JAPANESE YEN)"
01/09/1998,JPY,136.65,5.18%,0.0532,0.27,-5.23,136199,9078,24395,4,108204,86754,117286,111153,18913,25046,"(CONTRACTS OF 12,500,000 JAPANESE YEN)"
25/08/1998,JPY,144.11,0.55%,0.0055,0.31,-5.25,144169,4686,46368,343,126513,66601,131542,113312,12627,30857,"(CONTRACTS OF 12,500,000 JAPANESE YEN)"
18/08/1998,JPY,144.9,1.59%,0.016,0.39,-5.17,148067,9012,52437,593,126354,62200,135959,115230,12108,32837,"(CONTRACTS OF 12,500,000 JAPANESE YEN)"
11/08/1998,JPY,147.24,-1.66%,-0.0164,0.34,-5.29,150804,3873,58571,308,133525,57522,137706,116401,13098,34403,"(CONTRACTS OF 12,500,000 JAPANESE YEN)"
04/08/1998,JPY,144.84,-2.65%,-0.0262,0.42,-5.17,142444,7563,53271,281,122811,55565,130655,109117,11789,33327,"(CONTRACTS OF 12,500,000 JAPANESE YEN)"
28/07/1998,JPY,141.1,-0.59%,-0.0059,0.41,-5.18,116184,3130,41054,321,99801,46616,103252,87991,12932,28193,"(CONTRACTS OF 12,500,000 JAPANESE YEN)"
21/07/1998,JPY,140.27,-0.24%,-0.0024,0.78,-4.81,110323,5700,37902,237,90109,45265,96046,83404,14277,26919,"(CONTRACTS OF 12,500,000 JAPANESE YEN)"
14/07/1998,JPY,139.93,-0.89%,-0.0088,0.38,-5.18,107157,2540,35647,237,89867,45351,92644,81235,14513,25922,"(CONTRACTS OF 12,500,000 JAPANESE YEN)"
07/07/1998,JPY,138.7,0.00%,0,0.34,-5.22,111492,5381,35426,237,93987,51597,99605,87260,11887,24232,"(CONTRACTS OF 12,500,000 JAPANESE YEN)"
30/06/1998,JPY,138.7,0.39%,0.004,0.43,-5.16,108781,4604,33577,0,93609,50957,98213,84534,10568,24247,"(CONTRACTS OF 12,500,000 JAPANESE YEN)"
23/06/1998,JPY,139.25,2.79%,0.0283,0.34,-5.23,112988,3825,32696,0,96824,52076,100649,84772,12339,28216,"(CONTRACTS OF 12,500,000 JAPANESE YEN)"
16/06/1998,JPY,143.24,-2.20%,-0.0218,0.37,-5.19,118902,11528,58275,125,93267,24287,104920,82687,13982,36215,"(CONTRACTS OF 12,500,000 JAPANESE YEN)"
09/06/1998,JPY,140.15,-1.01%,-0.01,0.34,-5.22,154971,8524,69319,1007,130508,44209,140039,114535,14932,40436,"(CONTRACTS OF 12,500,000 JAPANESE YEN)"
02/06/1998,JPY,138.75,-0.69%,-0.0069,0.36,-5.2,131550,8122,66329,278,112061,28622,120461,95229,11089,36321,"(CONTRACTS OF 12,500,000 JAPANESE YEN)"
26/05/1998,JPY,137.8,-1.04%,-0.0104,0.36,-5.23,124590,4611,68089,65,105999,27579,110675,95733,13915,28857,"(CONTRACTS OF 12,500,000 JAPANESE YEN)"
19/05/1998,JPY,136.38,-1.81%,-0.018,0.35,-5.21,120892,3718,57144,227,104521,26501,108466,83872,12426,37020,"(CONTRACTS OF 12,500,000 JAPANESE YEN)"
12/05/1998,JPY,133.95,-1.84%,-0.0182,0.35,-5.21,92820,3272,35194,325,78456,25995,82053,61514,10767,31306,"(CONTRACTS OF 12,500,000 JAPANESE YEN)"
05/05/1998,JPY,131.53,0.51%,0.0051,0.45,-5.11,92803,6064,32805,400,69442,30898,75906,64103,16897,28700,"(CONTRACTS OF 12,500,000 JAPANESE YEN)"
28/04/1998,JPY,132.2,-0.72%,-0.0071,0.44,-5.19,88323,2056,32481,0,74905,28538,76961,61019,11362,27304,"(CONTRACTS OF 12,500,000 JAPANESE YEN)"
21/04/1998,JPY,131.26,-1.38%,-0.0137,0.31,-5.25,93359,3872,43195,3,77905,23142,81780,66340,11579,27019,"(CONTRACTS OF 12,500,000 JAPANESE YEN)"
14/04/1998,JPY,129.47,2.97%,0.0301,0.43,-5.13,89758,3826,41090,0,73013,20493,76839,61583,12919,28175,"(CONTRACTS OF 12,500,000 JAPANESE YEN)"
07/04/1998,JPY,133.43,-0.25%,-0.0025,0.45,-5.11,118672,4055,59980,0,102138,24092,106193,84072,12479,34600,"(CONTRACTS OF 12,500,000 JAPANESE YEN)"
31/03/1998,JPY,133.1,-2.17%,-0.0215,0.5,-5.09,99645,4090,46888,0,85085,22807,89175,69695,10470,29950,"(CONTRACTS OF 12,500,000 JAPANESE YEN)"
24/03/1998,JPY,130.27,-1.14%,-0.0113,0.54,-5.02,81988,4339,36444,0,68703,17654,73042,54098,8946,27890,"(CONTRACTS OF 12,500,000 JAPANESE YEN)"
17/03/1998,JPY,128.8,-1.10%,-0.0109,0.53,-5.03,68922,4937,26053,791,52362,16559,58090,43403,10832,25519,"(CONTRACTS OF 12,500,000 JAPANESE YEN)"
10/03/1998,JPY,127.4,-0.97%,-0.0096,0.54,-4.96,107136,4388,18505,336,86410,65052,91134,83893,16002,23243,"(CONTRACTS OF 12,500,000 JAPANESE YEN)"
03/03/1998,JPY,126.18,1.37%,0.0138,0.5,-5.03,97168,7090,16029,0,74783,61643,81873,77672,15295,19496,"(CONTRACTS OF 12,500,000 JAPANESE YEN)"
24/02/1998,JPY,127.93,-1.13%,-0.0112,0.43,-5.1,98205,8425,17673,100,74708,57979,83233,75752,14972,22453,"(CONTRACTS OF 12,500,000 JAPANESE YEN)"
17/02/1998,JPY,126.5,-2.66%,-0.0263,0.44,-5.06,104210,9330,15953,516,72605,67860,82451,84329,21759,19881,"(CONTRACTS OF 12,500,000 JAPANESE YEN)"
10/02/1998,JPY,123.22,2.04%,0.0206,0.41,-5.09,104328,18676,19553,50,62173,70247,80899,89850,23429,14478,"(CONTRACTS OF 12,500,000 JAPANESE YEN)"
03/02/1998,JPY,125.78,-0.36%,-0.0036,0.4,-5.08,98601,6556,30828,633,73200,49300,80389,80761,18212,17840,"(CONTRACTS OF 12,500,000 JAPANESE YEN)"
27/01/1998,JPY,125.33,2.39%,0.0242,0.39,-5.13,91369,6251,28881,0,67118,43809,73369,72690,18000,18679,"(CONTRACTS OF 12,500,000 JAPANESE YEN)"
20/01/1998,JPY,128.4,2.28%,0.0231,0.4,-5.1,91039,3475,33736,23,75058,32766,78556,66525,12483,24514,"(CONTRACTS OF 12,500,000 JAPANESE YEN)"
13/01/1998,JPY,131.4,1.70%,0.0171,0.31,-5.19,97500,2885,40497,0,84016,28208,86901,68705,10599,28795,"(CONTRACTS OF 12,500,000 JAPANESE YEN)"
06/01/1998,JPY,133.67,-16.23%,-0.1504,0.34,-5.28,100138,3729,45782,0,86534,25177,90263,70959,9875,29179,"(CONTRACTS OF 12,500,000 JAPANESE YEN)"
30/12/1997,JPY,115,11.01%,0.1167,0.36,-5.32,87300,3614,37572,0,73941,25340,77555,62912,9745,24388,"(CONTRACTS OF 12,500,000 JAPANESE YEN)"
23/12/1997,JPY,129.23,1.16%,0.0117,0.25,-5.53,89139,3504,38911,0,74117,24583,77621,63494,11518,25645,"(CONTRACTS OF 12,500,000 JAPANESE YEN)"
16/12/1997,JPY,130.75,-0.80%,-0.008,0.29,0.29,99991,4327,47413,0,85379,24170,89706,71583,10285,28408,"(CONTRACTS OF 12,500,000 JAPANESE YEN)"
09/12/1997,JPY,129.71,-0.88%,-0.0087,0.42,0.42,157450,6823,50423,0,130606,70707,137429,121130,20021,36320,"(CONTRACTS OF 12,500,000 JAPANESE YEN)"
02/12/1997,JPY,128.58,-1.04%,-0.0103,0.09,-5.77,143466,3730,46878,801,124683,61956,129214,109635,14252,33831,"(CONTRACTS OF 12,500,000 JAPANESE YEN)"
25/11/1997,JPY,127.26,-0.92%,-0.0092,0.09,-5.66,133612,6158,46365,827,112871,56579,119856,103771,13756,29841,"(CONTRACTS OF 12,500,000 JAPANESE YEN)"
18/11/1997,JPY,126.1,-1.04%,-0.0104,0.13,-5.62,138653,8915,46437,854,113982,60921,123751,108212,14902,30441,"(CONTRACTS OF 12,500,000 JAPANESE YEN)"
11/11/1997,JPY,124.8,-2.30%,-0.0227,0.3,-5.38,134949,11352,45487,0,111714,60441,123066,105928,11883,29021,"(CONTRACTS OF 12,500,000 JAPANESE YEN)"
04/11/1997,JPY,122,-1.22%,-0.0121,0.36,-5.32,108806,9965,30807,1,87499,56417,97465,87225,11341,21581,"(CONTRACTS OF 12,500,000 JAPANESE YEN)"
28/10/1997,JPY,120.53,0.26%,0.0027,0.42,-5.18,105651,12675,28930,0,72894,53393,85569,82323,20082,23328,"(CONTRACTS OF 12,500,000 JAPANESE YEN)"
21/10/1997,JPY,120.85,0.67%,0.0067,0.39,-5.29,87983,14984,25891,637,58204,41878,73825,68406,14158,19577,"(CONTRACTS OF 12,500,000 JAPANESE YEN)"
14/10/1997,JPY,121.66,0.60%,0.0061,0.43,-5.22,84844,8972,27741,340,62490,36196,71802,64277,13042,20567,"(CONTRACTS OF 12,500,000 JAPANESE YEN)"
07/10/1997,JPY,122.4,-1.58%,-0.0156,0.44,-5.12,88180,4373,37375,0,74709,25512,79082,62887,9098,25293,"(CONTRACTS OF 12,500,000 JAPANESE YEN)"
30/09/1997,JPY,120.5,1.24%,0.0125,0.44,-5.26,77580,4845,30978,0,60009,24118,64854,55096,12726,22484,"(CONTRACTS OF 12,500,000 JAPANESE YEN)"
23/09/1997,JPY,122.01,-0.65%,-0.0065,0.46,-5.12,76840,3593,28748,20,62681,21153,66294,49921,10546,26919,"(CONTRACTS OF 12,500,000 JAPANESE YEN)"
16/09/1997,JPY,121.22,-2.09%,-0.0207,0.5,-4.93,71476,2870,26091,0,59561,20759,62431,46850,9045,24626,"(CONTRACTS OF 12,500,000 JAPANESE YEN)"
09/09/1997,JPY,118.74,2.25%,0.0227,0.46,-5.1,125821,5446,25849,1184,97562,65038,104192,92071,21629,33750,"(CONTRACTS OF 12,500,000 JAPANESE YEN)"
02/09/1997,JPY,121.47,-2.94%,-0.029,0.42,-5.22,110153,6542,35856,2759,85882,38998,95183,77613,14970,32540,"(CONTRACTS OF 12,500,000 JAPANESE YEN)"
26/08/1997,JPY,118,0.17%,0.0017,0.48,-5.12,82931,3752,26500,2128,65147,36200,71027,64828,11904,18103,"(CONTRACTS OF 12,500,000 JAPANESE YEN)"
19/08/1997,JPY,118.2,-1.63%,-0.0162,0.53,-4.93,81269,2782,29512,2218,63245,29964,68245,61694,13024,19575,"(CONTRACTS OF 12,500,000 JAPANESE YEN)"
12/08/1997,JPY,116.3,2.43%,0.0246,0.43,-5.19,73356,2476,26801,1801,55297,25524,59574,54126,13782,19230,"(CONTRACTS OF 12,500,000 JAPANESE YEN)"
05/08/1997,JPY,119.2,-0.72%,-0.0072,0.45,-5.13,82030,2664,31990,1123,68498,20155,72285,53268,9745,28762,"(CONTRACTS OF 12,500,000 JAPANESE YEN)"
29/07/1997,JPY,118.35,-2.82%,-0.0278,0.48,-5.08,79533,5255,27342,1108,58833,25271,65196,53721,14337,25812,"(CONTRACTS OF 12,500,000 JAPANESE YEN)"
22/07/1997,JPY,115.1,0.43%,0.0043,0.65,-4.94,60054,11379,13996,1110,31203,27787,43692,42893,16362,17161,"(CONTRACTS OF 12,500,000 JAPANESE YEN)"
15/07/1997,JPY,115.6,-2.09%,-0.0207,0.65,-4.85,58461,12607,14201,726,24744,26078,38077,41005,20384,17456,"(CONTRACTS OF 12,500,000 JAPANESE YEN)"
08/07/1997,JPY,113.23,1.41%,0.0142,0.5,-5.12,60190,18518,10327,36,18066,39482,36620,49845,23570,10345,"(CONTRACTS OF 12,500,000 JAPANESE YEN)"
01/07/1997,JPY,114.85,-0.04%,-0.0004,0.46,-5.22,49743,13831,11363,250,14694,27434,28775,39047,20968,10696,"(CONTRACTS OF 12,500,000 JAPANESE YEN)"
24/06/1997,JPY,114.8,-1.41%,-0.014,0.59,-5.11,52859,12573,11435,265,20155,30904,32993,42604,19866,10255,"(CONTRACTS OF 12,500,000 JAPANESE YEN)"
17/06/1997,JPY,113.2,-0.85%,-0.0084,0.59,-5.05,50981,13951,9490,250,16547,31753,30748,41493,20233,9488,"(CONTRACTS OF 12,500,000 JAPANESE YEN)"
10/06/1997,JPY,112.25,3.23%,0.0329,0.46,-5.23,100978,20060,9755,1386,53989,74170,75435,85311,25543,15667,"(CONTRACTS OF 12,500,000 JAPANESE YEN)"
03/06/1997,JPY,116,0.53%,0.0053,0.46,-5.18,84109,21915,11076,462,37245,60122,59622,71660,24487,12449,"(CONTRACTS OF 12,500,000 JAPANESE YEN)"
27/05/1997,JPY,116.62,-3.52%,-0.0346,0.5,-5.19,85114,21221,11274,259,37584,59548,59064,71081,26050,14033,"(CONTRACTS OF 12,500,000 JAPANESE YEN)"
20/05/1997,JPY,112.65,4.89%,0.0501,0.43,-5.1,94323,25107,11527,451,38313,64592,63871,76570,30452,17753,"(CONTRACTS OF 12,500,000 JAPANESE YEN)"
13/05/1997,JPY,118.44,5.53%,0.0569,0.56,-5.15,81674,19871,12900,227,37417,54168,57515,67295,24159,14379,"(CONTRACTS OF 12,500,000 JAPANESE YEN)"
06/05/1997,JPY,125.37,1.15%,0.0116,0.42,-5.26,82137,3630,33435,10,60465,23969,64105,57414,18032,24723,"(CONTRACTS OF 12,500,000 JAPANESE YEN)"
29/04/1997,JPY,126.83,-0.42%,-0.0042,0.42,-5.26,87253,1664,37527,54,72066,21738,73784,59319,13469,27934,"(CONTRACTS OF 12,500,000 JAPANESE YEN)"
22/04/1997,JPY,126.3,-0.24%,-0.0024,0.56,-5.12,82536,1941,35535,62,66794,21164,68797,56761,13739,25775,"(CONTRACTS OF 12,500,000 JAPANESE YEN)"
15/04/1997,JPY,126,0.23%,0.0023,0.4,-5.3,84154,1875,35489,84,69440,20559,71399,56132,12755,28022,"(CONTRACTS OF 12,500,000 JAPANESE YEN)"
08/04/1997,JPY,126.29,-3.75%,-0.0368,0.53,-5.17,79690,2615,33255,83,63485,18188,66183,51526,13507,28164,"(CONTRACTS OF 12,500,000 JAPANESE YEN)"
01/04/1997,JPY,121.73,1.62%,0.0164,0.56,-5.12,68670,2699,26432,30,49308,20932,52037,47394,16633,21276,"(CONTRACTS OF 12,500,000 JAPANESE YEN)"
25/03/1997,JPY,123.74,-1.05%,-0.0105,0.68,-4.93,67862,2615,29642,0,52862,15574,55477,45216,12385,22646,"(CONTRACTS OF 12,500,000 JAPANESE YEN)"
18/03/1997,JPY,122.45,-0.53%,-0.0053,0.53,-5,61971,2046,27716,0,45600,13692,47646,41408,14325,20563,"(CONTRACTS OF 12,500,000 JAPANESE YEN)"
11/03/1997,JPY,121.8,0.28%,0.0028,0.31,-5.13,88163,2386,26613,9,68327,40512,70722,67134,17441,21029,"(CONTRACTS OF 12,500,000 JAPANESE YEN)"
04/03/1997,JPY,122.14,-0.44%,-0.0044,0.36,-5.05,78819,2380,27465,36,58956,30616,61372,58117,17447,20702,"(CONTRACTS OF 12,500,000 JAPANESE YEN)"
25/02/1997,JPY,121.6,1.82%,0.0183,0.33,-4.98,80390,2876,30127,41,60505,26715,63422,56883,16968,23507,"(CONTRACTS OF 12,500,000 JAPANESE YEN)"
18/02/1997,JPY,123.85,-0.45%,-0.0045,0.39,-4.95,82037,1079,34227,49,66928,24313,68056,58589,13981,23448,"(CONTRACTS OF 12,500,000 JAPANESE YEN)"
11/02/1997,JPY,123.3,-0.71%,-0.0071,0.33,-4.98,83850,923,35632,321,69560,24137,70804,60090,13046,23760,"(CONTRACTS OF 12,500,000 JAPANESE YEN)"
04/02/1997,JPY,122.43,-1.14%,-0.0113,0.35,-5.05,79874,3094,35897,0,64854,19674,67948,55571,11926,24303,"(CONTRACTS OF 12,500,000 JAPANESE YEN)"
28/01/1997,JPY,121.05,-2.67%,-0.0264,0.46,-4.96,75822,1708,34934,262,61097,16101,63067,51297,12755,24525,"(CONTRACTS OF 12,500,000 JAPANESE YEN)"
21/01/1997,JPY,117.9,-0.89%,-0.0089,0.33,-5.1,75440,800,33185,11,63705,17101,64516,50297,10924,25143,"(CONTRACTS OF 12,500,000 JAPANESE YEN)"
14/01/1997,JPY,116.86,-1.40%,-0.0139,0.32,-4.99,72957,791,33398,0,61620,13681,62411,47079,10546,25878,"(CONTRACTS OF 12,500,000 JAPANESE YEN)"
07/01/1997,JPY,115.25,0.56%,0.0056,0.42,-5,71117,237,31541,0,59422,13689,59659,45230,11458,25887,"(CONTRACTS OF 12,500,000 JAPANESE YEN)"
31/12/1996,JPY,115.9,-1.35%,-0.0134,0.31,-5.12,59781,1783,28258,290,48449,8955,50522,37503,9259,22278,"(CONTRACTS OF 12,500,000 JAPANESE YEN)"
24/12/1996,JPY,114.36,-0.45%,-0.0045,0.43,-5.03,54646,888,25988,66,43949,11119,44903,37173,9743,17473,"(CONTRACTS OF 12,500,000 JAPANESE YEN)"
17/12/1996,JPY,113.85,-0.39%,-0.0039,0.23,-5.25,54232,1302,25010,0,42968,9944,44270,34954,9962,19278,"(CONTRACTS OF 12,500,000 JAPANESE YEN)"
10/12/1996,JPY,113.41,-0.14%,-0.0014,0.28,-5.09,76579,1224,23968,232,62749,29321,64205,53521,12374,23058,"(CONTRACTS OF 12,500,000 JAPANESE YEN)"
03/12/1996,JPY,113.25,-0.67%,-0.0066,0.28,-5.28,76229,848,25438,41,60591,24883,61480,50362,14749,25867,"(CONTRACTS OF 12,500,000 JAPANESE YEN)"
26/11/1996,JPY,112.5,-0.81%,-0.008,0.36,-5.02,67412,2410,21413,278,51793,23886,54481,45577,12931,21835,"(CONTRACTS OF 12,500,000 JAPANESE YEN)"
19/11/1996,JPY,111.6,-0.13%,-0.0013,0.32,-5.05,71084,2331,21024,247,52563,29193,55141,50464,15943,20620,"(CONTRACTS OF 12,500,000 JAPANESE YEN)"
12/11/1996,JPY,111.45,2.43%,0.0246,0.35,-5.05,71473,1049,22226,260,56407,26219,57716,48705,13757,22768,"(CONTRACTS OF 12,500,000 JAPANESE YEN)"
05/11/1996,JPY,114.22,0.07%,0.0007,0.37,-5,75738,1198,30720,109,63301,16958,64608,47787,11130,27951,"(CONTRACTS OF 12,500,000 JAPANESE YEN)"
29/10/1996,JPY,114.3,-1.74%,-0.0173,0.34,-5.03,82265,1272,32823,118,68875,19419,70265,52360,12000,29905,"(CONTRACTS OF 12,500,000 JAPANESE YEN)"
22/10/1996,JPY,112.34,-0.11%,-0.0011,0.34,-5.06,74473,250,30285,148,63638,16314,64036,46747,10437,27726,"(CONTRACTS OF 12,500,000 JAPANESE YEN)"
15/10/1996,JPY,112.22,-0.51%,-0.0051,0.35,-5,76276,965,31767,275,62463,14270,63703,46312,12573,29964,"(CONTRACTS OF 12,500,000 JAPANESE YEN)"
08/10/1996,JPY,111.65,-0.19%,-0.0019,0.33,-5.06,76778,1440,32740,302,59868,13321,61610,46363,15168,30415,"(CONTRACTS OF 12,500,000 JAPANESE YEN)"
01/10/1996,JPY,111.44,-2.06%,-0.0204,0.35,-5.15,78542,3656,36254,535,62483,14490,66674,51279,11868,27263,"(CONTRACTS OF 12,500,000 JAPANESE YEN)"
24/09/1996,JPY,109.19,0.96%,0.0097,0.36,-5.01,72303,3500,33833,514,55725,15314,59739,49661,12564,22642,"(CONTRACTS OF 12,500,000 JAPANESE YEN)"
17/09/1996,JPY,110.25,-0.48%,-0.0048,0.36,-5.14,78955,2274,39958,0,67124,11817,69398,51775,9557,27180,"(CONTRACTS OF 12,500,000 JAPANESE YEN)"
10/09/1996,JPY,109.72,-0.45%,-0.0045,0.33,-5.16,102589,5323,36846,430,83809,35556,89562,72832,13027,29757,"(CONTRACTS OF 12,500,000 JAPANESE YEN)"
03/09/1996,JPY,109.23,-1.47%,-0.0146,0.36,-5.14,86286,5962,24456,2264,63717,31390,71943,58110,14343,28176,"(CONTRACTS OF 12,500,000 JAPANESE YEN)"
27/08/1996,JPY,107.65,0.59%,0.0059,0.46,-4.85,78052,5695,22820,2410,55406,28907,63511,54137,14541,23915,"(CONTRACTS OF 12,500,000 JAPANESE YEN)"
20/08/1996,JPY,108.29,-0.61%,-0.0061,0.5,-4.87,71701,7225,20120,1841,49887,28647,58953,50608,12748,21093,"(CONTRACTS OF 12,500,000 JAPANESE YEN)"
13/08/1996,JPY,107.63,-0.80%,-0.0079,0.37,-5.01,68444,6770,18906,1894,46235,29024,54899,49824,13545,18620,"(CONTRACTS OF 12,500,000 JAPANESE YEN)"
06/08/1996,JPY,106.78,1.07%,0.0107,0.65,-4.75,71289,8881,18179,1173,43558,34030,53612,53382,17677,17907,"(CONTRACTS OF 12,500,000 JAPANESE YEN)"
30/07/1996,JPY,107.93,-0.12%,-0.0012,0.45,-5.11,72041,2657,27025,1122,53739,19356,57518,47503,14523,24538,"(CONTRACTS OF 12,500,000 JAPANESE YEN)"
23/07/1996,JPY,107.8,1.39%,0.014,0.68,-4.75,72207,2691,26372,1475,52180,21591,56346,49438,15861,22769,"(CONTRACTS OF 12,500,000 JAPANESE YEN)"
16/07/1996,JPY,109.32,0.98%,0.0098,0.65,-4.78,79906,2008,32354,1119,60362,19208,63489,52681,16417,27225,"(CONTRACTS OF 12,500,000 JAPANESE YEN)"
09/07/1996,JPY,110.4,-0.08%,-0.0008,0.56,-5.03,82820,2112,36363,634,68109,17334,70855,54331,11965,28489,"(CONTRACTS OF 12,500,000 JAPANESE YEN)"
02/07/1996,JPY,110.31,-1.31%,-0.013,0.53,-4.84,82027,1459,35647,930,68893,16732,71282,53309,10745,28718,"(CONTRACTS OF 12,500,000 JAPANESE YEN)"
25/06/1996,JPY,108.88,-1.05%,-0.0104,0.56,-4.87,71198,1319,29375,700,56996,16202,59015,46277,12183,24921,"(CONTRACTS OF 12,500,000 JAPANESE YEN)"
18/06/1996,JPY,107.75,1.59%,0.016,0.41,-4.99,70593,800,29985,737,56800,11913,58337,42635,12256,27958,"(CONTRACTS OF 12,500,000 JAPANESE YEN)"
11/06/1996,JPY,109.49,-0.63%,-0.0063,0.42,-5.01,98760,2009,32757,712,81670,35618,84391,69087,14369,29673,"(CONTRACTS OF 12,500,000 JAPANESE YEN)"
04/06/1996,JPY,108.8,0.02%,0.0002,0.4,-4.97,90273,1531,31613,0,75474,27380,77005,58993,13268,31280,"(CONTRACTS OF 12,500,000 JAPANESE YEN)"
28/05/1996,JPY,108.82,-1.56%,-0.0155,0.38,-4.96,84612,3736,27607,1177,67422,27284,72335,56068,12277,28544,"(CONTRACTS OF 12,500,000 JAPANESE YEN)"
21/05/1996,JPY,107.15,-1.28%,-0.0127,0.5,-4.93,75454,4335,19841,1176,54146,29248,59657,50265,15797,25189,"(CONTRACTS OF 12,500,000 JAPANESE YEN)"
14/05/1996,JPY,105.8,-0.57%,-0.0057,0.65,-4.66,68985,7548,17572,1036,42368,30094,50952,48702,18033,20283,"(CONTRACTS OF 12,500,000 JAPANESE YEN)"
07/05/1996,JPY,105.2,-0.19%,-0.0019,0.53,-4.97,69235,9514,18025,924,39055,32100,49493,51049,19742,18186,"(CONTRACTS OF 12,500,000 JAPANESE YEN)"
30/04/1996,JPY,105,1.62%,0.0163,0.65,-4.72,68490,8724,17911,1058,40809,29904,50591,48873,17899,19617,"(CONTRACTS OF 12,500,000 JAPANESE YEN)"
23/04/1996,JPY,106.73,1.27%,0.0128,0.53,-4.78,70632,2660,24586,756,54736,20899,58152,46241,12480,24391,"(CONTRACTS OF 12,500,000 JAPANESE YEN)"
16/04/1996,JPY,108.1,0.18%,0.0018,0.56,-4.75,80629,2771,35345,630,67568,15389,70969,51364,9660,29265,"(CONTRACTS OF 12,500,000 JAPANESE YEN)"
09/04/1996,JPY,108.29,-0.69%,-0.0069,0.53,-4.65,83973,2071,37766,492,73681,15595,76244,53853,7729,30120,"(CONTRACTS OF 12,500,000 JAPANESE YEN)"
02/04/1996,JPY,107.55,-1.07%,-0.0107,0.53,-4.81,77944,1040,34940,437,66342,14169,67819,49546,10125,28398,"(CONTRACTS OF 12,500,000 JAPANESE YEN)"
26/03/1996,JPY,106.41,-0.26%,-0.0026,0.43,-5.03,68100,261,29925,460,56977,11361,57698,41746,10402,26354,"(CONTRACTS OF 12,500,000 JAPANESE YEN)"
19/03/1996,JPY,106.13,-0.81%,-0.008,0.62,-4.68,58846,513,24871,429,48264,10859,49206,36159,9640,22687,"(CONTRACTS OF 12,500,000 JAPANESE YEN)"
12/03/1996,JPY,105.28,-0.08%,-0.0008,0.39,-4.86,74241,1695,21407,839,58250,30651,60784,52897,13457,21344,"(CONTRACTS OF 12,500,000 JAPANESE YEN)"
05/03/1996,JPY,105.2,-0.85%,-0.0085,0.44,-4.68,70199,1985,21830,624,53030,26650,55639,49104,14560,21095,"(CONTRACTS OF 12,500,000 JAPANESE YEN)"
27/02/1996,JPY,104.31,1.24%,0.0125,0.5,-4.64,73756,3914,24583,851,53488,25845,58253,51279,15503,22477,"(CONTRACTS OF 12,500,000 JAPANESE YEN)"
20/02/1996,JPY,105.62,1.06%,0.0106,0.48,-4.7,79626,1978,30603,687,63132,23203,65797,54493,13829,25133,"(CONTRACTS OF 12,500,000 JAPANESE YEN)"
13/02/1996,JPY,106.75,-1.57%,-0.0156,0.43,-4.69,81446,1292,31870,1136,68776,19278,71204,52284,10242,29162,"(CONTRACTS OF 12,500,000 JAPANESE YEN)"
06/02/1996,JPY,105.1,1.98%,0.02,0.34,-4.8,76388,607,31542,1204,64178,16505,65989,49251,10399,27137,"(CONTRACTS OF 12,500,000 JAPANESE YEN)"
30/01/1996,JPY,107.22,-1.30%,-0.013,0.37,-4.81,84717,1085,38120,1011,75096,14150,77192,53281,7525,31436,"(CONTRACTS OF 12,500,000 JAPANESE YEN)"
23/01/1996,JPY,105.84,0.11%,0.0011,0.33,-4.97,80456,1342,37140,623,69557,12743,71522,50506,8934,29950,"(CONTRACTS OF 12,500,000 JAPANESE YEN)"
16/01/1996,JPY,105.96,-1.49%,-0.0148,0.35,-4.98,84284,1274,38262,816,72606,12167,74696,51245,9588,33039,"(CONTRACTS OF 12,500,000 JAPANESE YEN)"
09/01/1996,JPY,104.4,-0.46%,-0.0046,0.38,-5.03,78227,1578,34834,700,67780,12205,70058,47739,8169,30488,"(CONTRACTS OF 12,500,000 JAPANESE YEN)"
02/01/1996,JPY,103.92,-1.61%,-0.016,0.32,-5.11,71890,1328,33627,621,62923,10271,64872,44519,7018,27371,"(CONTRACTS OF 12,500,000 JAPANESE YEN)"
26/12/1995,JPY,102.27,-0.31%,-0.0031,0.5,-5,63213,776,28850,509,55131,11246,56416,40605,6797,22608,"(CONTRACTS OF 12,500,000 JAPANESE YEN)"
19/12/1995,JPY,101.95,-0.16%,-0.0016,0.43,-5.07,55726,673,23717,291,47910,10583,48874,34591,6852,21135,"(CONTRACTS OF 12,500,000 JAPANESE YEN)"
12/12/1995,JPY,101.79,-0.53%,-0.0053,0.46,-5.2,78456,3796,23070,935,62671,27716,67402,51721,11054,26735,"(CONTRACTS OF 12,500,000 JAPANESE YEN)"
05/12/1995,JPY,101.25,-0.05%,-0.0005,0.27,-5.38,70992,3198,21962,1201,56542,22273,60941,45436,10051,25556,"(CONTRACTS OF 12,500,000 JAPANESE YEN)"
28/11/1995,JPY,101.2,0.30%,0.003,0.27,-5.42,72461,3429,22561,1350,56462,21428,61241,45339,11220,27122,"(CONTRACTS OF 12,500,000 JAPANESE YEN)"
21/11/1995,JPY,101.5,0.15%,0.0015,0.53,-5.31,72962,3490,24154,1361,56229,19996,61080,45511,11882,27451,"(CONTRACTS OF 12,500,000 JAPANESE YEN)"
14/11/1995,JPY,101.65,1.26%,0.0127,0.18,-5.44,71125,483,23532,1550,58449,19908,60482,44990,10643,26135,"(CONTRACTS OF 12,500,000 JAPANESE YEN)"
07/11/1995,JPY,102.95,-0.93%,-0.0093,0.53,-5.17,76844,833,25896,1107,63172,19778,65112,46781,11732,30063,"(CONTRACTS OF 12,500,000 JAPANESE YEN)"
31/10/1995,JPY,102,-1.54%,-0.0153,0.15,-5.66,71121,812,23024,1061,58987,19460,60860,43545,10261,27576,"(CONTRACTS OF 12,500,000 JAPANESE YEN)"
24/10/1995,JPY,100.45,-0.15%,-0.0015,0.05,-5.76,66502,1467,21514,1747,52825,19442,56039,42703,10463,23799,"(CONTRACTS OF 12,500,000 JAPANESE YEN)"
17/10/1995,JPY,100.3,0.57%,0.0058,0.05,-5.7,65330,1694,22858,900,52446,17881,55040,41639,10290,23691,"(CONTRACTS OF 12,500,000 JAPANESE YEN)"
10/10/1995,JPY,100.88,0.66%,0.0066,0.17,-5.56,67060,1328,22111,4775,51756,17633,57859,44519,9201,22541,"(CONTRACTS OF 12,500,000 JAPANESE YEN)"
03/10/1995,JPY,101.55,-0.61%,-0.0061,0.5,-5.28,66926,1531,22492,4396,51748,16433,57675,43321,9251,23605,"(CONTRACTS OF 12,500,000 JAPANESE YEN)"
26/09/1995,JPY,100.93,3.37%,0.0343,0.46,-5.24,64851,1509,21720,3893,51192,16877,56594,42490,8257,22361,"(CONTRACTS OF 12,500,000 JAPANESE YEN)"
19/09/1995,JPY,104.45,-3.36%,-0.0331,0.5,-5.16,66246,2826,21236,2912,52437,15531,58175,39679,8071,26567,"(CONTRACTS OF 12,500,000 JAPANESE YEN)"
12/09/1995,JPY,101.05,-3.49%,-0.0343,0.56,-5.12,84762,3309,21748,2644,65251,27454,71204,51846,13558,32916,"(CONTRACTS OF 12,500,000 JAPANESE YEN)"
05/09/1995,JPY,97.64,0.55%,0.0055,0.81,-4.81,69898,3981,19323,2080,54029,19113,60090,40516,9808,29382,"(CONTRACTS OF 12,500,000 JAPANESE YEN)"
29/08/1995,JPY,98.18,-1.34%,-0.0133,0.81,-4.94,70417,5138,19272,2221,52839,18733,60198,40226,10219,30191,"(CONTRACTS OF 12,500,000 JAPANESE YEN)"
22/08/1995,JPY,96.88,0.33%,0.0033,0.87,-5,66558,5224,20773,1895,50916,14326,58035,36994,8523,29564,"(CONTRACTS OF 12,500,000 JAPANESE YEN)"
15/08/1995,JPY,97.2,-6.24%,-0.0605,0.87,-4.94,62361,2780,19498,2090,45884,11210,50754,32798,11607,29563,"(CONTRACTS OF 12,500,000 JAPANESE YEN)"
08/08/1995,JPY,91.49,-3.88%,-0.0381,0.78,-4.94,60382,3927,18511,1109,46487,11136,51523,30756,8859,29626,"(CONTRACTS OF 12,500,000 JAPANESE YEN)"
01/08/1995,JPY,88.07,-0.11%,-0.0011,0.75,-5,52390,2873,15832,1087,39821,10503,43781,27422,8609,24968,"(CONTRACTS OF 12,500,000 JAPANESE YEN)"
25/07/1995,JPY,87.97,0.40%,0.004,0.81,-4.98,53017,2487,16153,1320,40528,10389,44335,27862,8682,25155,"(CONTRACTS OF 12,500,000 JAPANESE YEN)"
18/07/1995,JPY,88.32,-0.88%,-0.0088,0.81,-4.91,51837,3766,16024,1332,38146,9189,43244,26545,8593,25292,"(CONTRACTS OF 12,500,000 JAPANESE YEN)"
11/07/1995,JPY,87.55,-3.29%,-0.0324,0.87,-4.85,47853,3774,14700,6,35616,9264,39396,23970,8457,23883,"(CONTRACTS OF 12,500,000 JAPANESE YEN)"
03/07/1995,JPY,84.76,-0.68%,-0.0067,1.13,-4.72,38981,2233,11279,493,28717,9514,31443,21286,7538,17695,"(CONTRACTS OF 12,500,000 JAPANESE YEN)"
27/06/1995,JPY,84.19,0.37%,0.0037,1.12,-4.73,35848,3705,7581,539,22310,10749,26554,18869,9294,16979,"(CONTRACTS OF 12,500,000 JAPANESE YEN)"
20/06/1995,JPY,84.5,0.14%,0.0014,1.15,-4.74,35188,3110,8627,907,21840,9707,25857,19241,9331,15947,"(CONTRACTS OF 12,500,000 JAPANESE YEN)"
13/06/1995,JPY,84.62,0.12%,0.0012,1.06,-4.65,70892,4766,9586,1669,50014,40640,56449,51895,14443,18997,"(CONTRACTS OF 12,500,000 JAPANESE YEN)"
06/06/1995,JPY,84.72,-2.20%,-0.0217,1.12,-4.69,68074,6710,10484,1864,46201,38054,54775,50402,13299,17672,"(CONTRACTS OF 12,500,000 JAPANESE YEN)"
30/05/1995,JPY,82.9,4.84%,0.0497,1.18,-4.75,69703,6705,9084,3902,44159,38623,54766,51609,14937,18094,"(CONTRACTS OF 12,500,000 JAPANESE YEN)"
23/05/1995,JPY,87.12,-0.60%,-0.006,1.31,-4.69,67121,5010,12694,3814,46642,29846,55466,46354,11655,20767,"(CONTRACTS OF 12,500,000 JAPANESE YEN)"
16/05/1995,JPY,86.6,-3.95%,-0.0387,1.31,-4.72,68725,6324,10263,3906,44535,33425,54765,47594,13960,21131,"(CONTRACTS OF 12,500,000 JAPANESE YEN)"
09/05/1995,JPY,83.31,0.29%,0.0029,1.31,-4.5,70164,9095,8327,4264,40345,38816,53704,51407,16460,18757,"(CONTRACTS OF 12,500,000 JAPANESE YEN)"
02/05/1995,JPY,83.55,-2.08%,-0.0206,1.37,-4.69,63835,9454,5781,3701,34595,36055,47750,45537,16085,18298,"(CONTRACTS OF 12,500,000 JAPANESE YEN)"
25/04/1995,JPY,81.85,-1.53%,-0.0151,1.34,-4.7,64032,9477,4672,3504,32215,35606,45196,43782,18836,20250,"(CONTRACTS OF 12,500,000 JAPANESE YEN)"
18/04/1995,JPY,80.62,3.44%,0.035,1.25,-4.81,65264,12296,7146,3289,31293,32639,46878,43074,18386,22190,"(CONTRACTS OF 12,500,000 JAPANESE YEN)"
11/04/1995,JPY,83.49,3.03%,0.0308,1.62,-4.5,62991,10507,5740,3085,29125,30632,42717,39457,20274,23534,"(CONTRACTS OF 12,500,000 JAPANESE YEN)"
04/04/1995,JPY,86.1,3.15%,0.032,1.62,-4.56,61198,14081,8454,2284,25002,29166,41367,39904,19831,21294,"(CONTRACTS OF 12,500,000 JAPANESE YEN)"
28/03/1995,JPY,88.9,0.30%,0.003,1.93,-4.19,58807,14590,9593,2048,24138,27325,40776,38966,18031,19841,"(CONTRACTS OF 12,500,000 JAPANESE YEN)"
21/03/1995,JPY,89.17,1.85%,0.0187,2.09,-4.01,59405,16598,9322,1536,22865,27955,40999,38813,18406,20592,"(CONTRACTS OF 12,500,000 JAPANESE YEN)"
14/03/1995,JPY,90.85,-0.78%,-0.0077,2.09,-4.03,97055,14981,9816,1892,24366,26819,41239,38527,55816,58528,"(CONTRACTS OF 12,500,000 JAPANESE YEN)"
07/03/1995,JPY,90.15,6.79%,0.0703,2.12,-4,110580,15308,13112,2239,62288,56634,79835,71985,30745,38595,"(CONTRACTS OF 12,500,000 JAPANESE YEN)"
28/02/1995,JPY,96.72,0.34%,0.0034,2.25,-3.87,94456,9875,10745,3156,63596,51408,76627,65309,17829,29147,"(CONTRACTS OF 12,500,000 JAPANESE YEN)"
21/02/1995,JPY,97.05,1.49%,0.015,2.21,-3.9,90189,6117,9925,3563,63226,48150,72906,61638,17283,28551,"(CONTRACTS OF 12,500,000 JAPANESE YEN)"
14/02/1995,JPY,98.52,0.95%,0.0095,2.25,-3.87,83792,1846,25509,3116,65115,26981,70077,55606,13715,28186,"(CONTRACTS OF 12,500,000 JAPANESE YEN)"
07/02/1995,JPY,99.46,0.09%,0.0009,2.31,-3.81,84900,1644,29154,3302,69421,24546,74367,57002,10533,27898,"(CONTRACTS OF 12,500,000 JAPANESE YEN)"
31/01/1995,JPY,99.55,0.18%,0.0018,2.25,-3.87,85272,2193,28432,2988,67452,25555,72633,56975,12639,28297,"(CONTRACTS OF 12,500,000 JAPANESE YEN)"
24/01/1995,JPY,99.73,-0.63%,-0.0062,2.25,-3.96,83432,1942,26836,3395,67301,24838,72638,55069,10794,28363,"(CONTRACTS OF 12,500,000 JAPANESE YEN)"
17/01/1995,JPY,99.11,0.95%,0.0095,2.31,-3.81,86134,2283,26464,3483,69453,25008,75219,54955,10915,31179,"(CONTRACTS OF 12,500,000 JAPANESE YEN)"
10/01/1995,JPY,100.06,0.59%,0.0059,2.31,-3.87,91881,768,41068,2637,79904,15143,83309,58848,8572,33033,"(CONTRACTS OF 12,500,000 JAPANESE YEN)"
03/01/1995,JPY,100.65,-0.35%,-0.0035,2.31,-4,79062,594,34318,2872,67485,10623,70951,47813,8111,31249,"(CONTRACTS OF 12,500,000 JAPANESE YEN)"
27/12/1994,JPY,100.3,-0.13%,-0.0013,2.21,-3.97,75424,2533,33182,1736,64400,10507,68669,45425,6755,29999,"(CONTRACTS OF 12,500,000 JAPANESE YEN)"
20/12/1994,JPY,100.17,0.08%,0.0008,2.31,-3.75,99621,1844,32344,1568,62783,10456,66195,44368,33426,55253,"(CONTRACTS OF 12,500,000 JAPANESE YEN)"
13/12/1994,JPY,100.25,-0.22%,-0.0022,2.28,-4.03,104478,2874,40412,5108,84594,26463,92576,71983,11902,32495,"(CONTRACTS OF 12,500,000 JAPANESE YEN)"
06/12/1994,JPY,100.03,-1.09%,-0.0109,2.28,-3.9,101704,3688,39412,6778,78980,20518,89446,66708,12258,34996,"(CONTRACTS OF 12,500,000 JAPANESE YEN)"
29/11/1994,JPY,98.95,-0.66%,-0.0066,2.31,-3.62,88930,4998,30275,5153,64188,23915,74339,59343,14591,29587,"(CONTRACTS OF 12,500,000 JAPANESE YEN)"
22/11/1994,JPY,98.3,0.44%,0.0044,2.31,-3.37,86959,4675,28480,5013,61952,26595,71640,60088,15319,26871,"(CONTRACTS OF 12,500,000 JAPANESE YEN)"
15/11/1994,JPY,98.73,-1.68%,-0.0166,2.31,-3.44,80629,5431,22845,4138,56339,26769,65908,53752,14721,26877,"(CONTRACTS OF 12,500,000 JAPANESE YEN)"
08/11/1994,JPY,97.1,-0.48%,-0.0047,2.31,-3.44,75024,7257,17522,3960,48085,27147,59302,48629,15722,26395,"(CONTRACTS OF 12,500,000 JAPANESE YEN)"
01/11/1994,JPY,96.64,0.32%,0.0032,2.31,-3.24,70377,7954,13063,4196,40127,26110,52277,43369,18100,27008,"(CONTRACTS OF 12,500,000 JAPANESE YEN)"
25/10/1994,JPY,96.95,0.72%,0.0072,2.31,-3.25,68467,8638,12067,4266,36676,25886,49580,42219,18887,26248,"(CONTRACTS OF 12,500,000 JAPANESE YEN)"
18/10/1994,JPY,97.65,2.58%,0.0262,2.34,-3.09,63023,5572,13127,3302,40117,19217,48991,35646,14032,27377,"(CONTRACTS OF 12,500,000 JAPANESE YEN)"
11/10/1994,JPY,100.24,-0.69%,-0.0069,2.34,-3.16,63724,3140,16559,1951,49592,13895,54683,32405,9041,31319,"(CONTRACTS OF 12,500,000 JAPANESE YEN)"
04/10/1994,JPY,99.55,-1.64%,-0.0163,2.28,-3.09,52336,3116,10655,1451,34538,16135,39105,28241,13231,24095,"(CONTRACTS OF 12,500,000 JAPANESE YEN)"
27/09/1994,JPY,97.94,-0.27%,-0.0027,2.28,-2.84,48160,4668,7264,1799,24328,17722,30795,26785,17365,21375,"(CONTRACTS OF 12,500,000 JAPANESE YEN)"
20/09/1994,JPY,97.68,1.08%,0.0109,2.28,-2.65,72975,6598,8050,1801,24299,15597,32698,25448,40277,47527,"(CONTRACTS OF 12,500,000 JAPANESE YEN)"
13/09/1994,JPY,98.75,-0.05%,-0.0005,2.31,-2.59,70026,2254,12350,2761,50404,30386,55419,45497,14607,24529,"(CONTRACTS OF 12,500,000 JAPANESE YEN)"
06/09/1994,JPY,98.7,0.83%,0.0084,2.28,-2.58,72539,3573,14172,2634,48776,29064,54983,45870,17556,26669,"(CONTRACTS OF 12,500,000 JAPANESE YEN)"
30/08/1994,JPY,99.53,-1.73%,-0.0171,2.31,-2.56,72090,4334,15560,2603,48623,26777,55560,44940,16530,27150,"(CONTRACTS OF 12,500,000 JAPANESE YEN)"
23/08/1994,JPY,97.84,2.70%,0.0274,2.25,-2.58,74347,6366,15049,2130,47069,30404,55565,47583,18782,26764,"(CONTRACTS OF 12,500,000 JAPANESE YEN)"
16/08/1994,JPY,100.56,0.58%,0.0058,2.25,-2.68,72160,4855,16509,1165,51668,22880,57688,40554,14472,31606,"(CONTRACTS OF 12,500,000 JAPANESE YEN)"
09/08/1994,JPY,101.15,-0.77%,-0.0076,2.28,-2.47,73474,3217,16534,1291,51266,24212,55774,42037,17700,31437,"(CONTRACTS OF 12,500,000 JAPANESE YEN)"
02/08/1994,JPY,100.38,-2.16%,-0.0213,2.21,-2.35,73413,5082,14063,1386,45612,27579,52080,43028,21333,30385,"(CONTRACTS OF 12,500,000 JAPANESE YEN)"
26/07/1994,JPY,98.26,0.85%,0.0085,2.12,-2.55,75748,8968,12474,1226,42173,30831,52367,44531,23381,31217,"(CONTRACTS OF 12,500,000 JAPANESE YEN)"
19/07/1994,JPY,99.1,-1.72%,-0.0171,2.05,-2.38,75196,9495,13574,1196,39638,29314,50329,44084,24867,31112,"(CONTRACTS OF 12,500,000 JAPANESE YEN)"
12/07/1994,JPY,97.42,1.55%,0.0156,2.06,-2.62,73980,10866,10150,581,38911,31297,50358,42028,23622,31952,"(CONTRACTS OF 12,500,000 JAPANESE YEN)"
05/07/1994,JPY,98.95,0.85%,0.0086,2.06,-2.73,68419,10585,8402,689,32579,31317,43853,40408,24566,28011,"(CONTRACTS OF 12,500,000 JAPANESE YEN)"
28/06/1994,JPY,99.8,0.44%,0.0044,2.09,-2.47,65551,8992,12789,281,34550,25739,43823,38809,21728,26742,"(CONTRACTS OF 12,500,000 JAPANESE YEN)"
21/06/1994,JPY,100.24,2.45%,0.0248,2.12,-2.38,63074,7421,10751,430,34658,22207,42509,33388,20565,29686,"(CONTRACTS OF 12,500,000 JAPANESE YEN)"
14/06/1994,JPY,102.76,1.45%,0.0146,2.06,-2.25,79926,4537,14001,824,54951,26576,60312,41401,19614,38525,"(CONTRACTS OF 12,500,000 JAPANESE YEN)"
07/06/1994,JPY,104.27,0.41%,0.0041,2.06,-2.35,84052,1491,19494,6330,59938,23753,67759,49577,16293,34475,"(CONTRACTS OF 12,500,000 JAPANESE YEN)"
31/05/1994,JPY,104.7,-0.04%,-0.0004,2.12,-2.38,71275,3773,17886,2756,52392,18783,58921,39425,12354,31850,"(CONTRACTS OF 12,500,000 JAPANESE YEN)"
24/05/1994,JPY,104.66,-0.01%,-0.0001,2.12,-2.38,70215,5144,19418,2492,50154,19201,57790,41111,12425,29104,"(CONTRACTS OF 12,500,000 JAPANESE YEN)"
17/05/1994,JPY,104.65,-0.22%,-0.0022,2.12,-2.5,64182,4270,14873,2444,44956,19548,51670,36865,12512,27317,"(CONTRACTS OF 12,500,000 JAPANESE YEN)"
10/05/1994,JPY,104.42,-3.42%,-0.0336,2.18,-2.6,62470,6079,14826,678,36284,22863,43041,38367,19429,24103,"(CONTRACTS OF 12,500,000 JAPANESE YEN)"
03/05/1994,JPY,100.97,1.76%,0.0178,2.25,-2.04,67119,13046,11694,1350,27299,28412,41695,41456,25424,25663,"(CONTRACTS OF 12,500,000 JAPANESE YEN)"
26/04/1994,JPY,102.78,0.43%,0.0043,2.25,-1.87,58882,9221,9532,1098,28583,22583,38902,33213,19980,25669,"(CONTRACTS OF 12,500,000 JAPANESE YEN)"
19/04/1994,JPY,103.22,0.41%,0.0042,2.25,-1.81,56896,9098,11566,939,27259,20495,37296,33000,19600,23896,"(CONTRACTS OF 12,500,000 JAPANESE YEN)"
12/04/1994,JPY,103.65,0.72%,0.0072,2.21,-1.67,55960,9301,12427,830,24988,19010,35119,32267,20841,23693,"(CONTRACTS OF 12,500,000 JAPANESE YEN)"
05/04/1994,JPY,104.4,-1.26%,-0.0125,2.25,-1.68,57101,11131,11538,914,23941,22073,35986,34525,21115,22576,"(CONTRACTS OF 12,500,000 JAPANESE YEN)"
29/03/1994,JPY,103.1,2.75%,0.0278,2.25,-1.48,53287,5503,11558,809,27737,18293,34049,30660,19238,22627,"(CONTRACTS OF 12,500,000 JAPANESE YEN)"
22/03/1994,JPY,106.01,-0.01%,-0.0001,2.37,-1.31,50508,3331,12310,971,32027,15054,36329,28335,14179,22173,"(CONTRACTS OF 12,500,000 JAPANESE YEN)"
15/03/1994,JPY,106,-0.72%,-0.0072,2.28,-1.47,94943,9697,11666,603,22940,15650,33240,27919,61703,67024,"(CONTRACTS OF 12,500,000 JAPANESE YEN)"
08/03/1994,JPY,105.24,-0.67%,-0.0067,2.25,-1.56,93851,13639,10505,2569,54282,57069,70490,70143,23361,23708,"(CONTRACTS OF 12,500,000 JAPANESE YEN)"
01/03/1994,JPY,104.54,1.00%,0.0101,2.31,-1.31,98853,19382,10854,3453,50122,61196,72957,75503,25896,23350,"(CONTRACTS OF 12,500,000 JAPANESE YEN)"
22/02/1994,JPY,105.6,-1.78%,-0.0177,2.18,-1.32,100123,21985,8785,4100,48710,62311,74795,75196,25328,24927,"(CONTRACTS OF 12,500,000 JAPANESE YEN)"
15/02/1994,JPY,103.75,4.58%,0.0469,2.12,-1.25,103131,22648,11481,4479,48953,55323,76080,71283,27051,31848,"(CONTRACTS OF 12,500,000 JAPANESE YEN)"
08/02/1994,JPY,108.73,-1.03%,-0.0103,2.18,-1.25,86434,8700,15066,4198,56426,40520,69324,59784,17110,26650,"(CONTRACTS OF 12,500,000 JAPANESE YEN)"
01/02/1994,JPY,107.62,2.96%,0.03,2.18,-1,84861,4406,13925,4330,60077,36894,68813,55149,16048,29712,"(CONTRACTS OF 12,500,000 JAPANESE YEN)"
25/01/1994,JPY,110.9,-0.14%,-0.0014,2.12,-1,100271,3350,36313,4527,80988,24182,88865,65022,11406,35249,"(CONTRACTS OF 12,500,000 JAPANESE YEN)"
18/01/1994,JPY,110.75,1.44%,0.0145,2.12,-1,106559,23459,42069,4322,66672,22796,94453,69187,12106,37372,"(CONTRACTS OF 12,500,000 JAPANESE YEN)"
11/01/1994,JPY,112.37,0.22%,0.0022,2.18,-0.94,105981,23920,44511,3763,67235,20690,94918,68964,11063,37017,"(CONTRACTS OF 12,500,000 JAPANESE YEN)"
04/01/1994,JPY,112.62,-1.10%,-0.011,2.09,-1.09,103821,25528,47798,2986,65201,15562,93715,66346,10106,37475,"(CONTRACTS OF 12,500,000 JAPANESE YEN)"
28/12/1993,JPY,111.39,-0.26%,-0.0026,2,-1.12,100336,3296,46395,2366,85651,15603,91313,64364,9023,35972,"(CONTRACTS OF 12,500,000 JAPANESE YEN)"
21/12/1993,JPY,111.1,-1.61%,-0.016,2.06,-1.12,101590,3598,46325,2407,87637,14754,93642,63486,7948,38104,"(CONTRACTS OF 12,500,000 JAPANESE YEN)"
14/12/1993,JPY,109.34,-1.76%,-0.0174,2.06,-1.12,98111,2549,28413,1090,83018,34027,86657,63530,11454,34581,"(CONTRACTS OF 12,500,000 JAPANESE YEN)"
07/12/1993,JPY,107.45,1.48%,0.0149,2,-1.3,90361,2318,22090,2765,70534,30731,75617,55586,14744,34775,"(CONTRACTS OF 12,500,000 JAPANESE YEN)"
30/11/1993,JPY,109.06,-0.38%,-0.0038,2.09,-1.29,92775,2265,24897,4764,70195,25783,77224,55444,15551,37331,"(CONTRACTS OF 12,500,000 JAPANESE YEN)"
23/11/1993,JPY,108.65,-1.80%,-0.0178,2.31,-1.04,82388,1934,16737,3450,64072,26585,69456,46772,12932,35616,"(CONTRACTS OF 12,500,000 JAPANESE YEN)"
16/11/1993,JPY,106.73,1.08%,0.0109,2.34,-0.97,76575,5364,15419,3620,51092,32793,60076,51832,16499,24743,"(CONTRACTS OF 12,500,000 JAPANESE YEN)"
09/11/1993,JPY,107.9,-0.14%,-0.0014,2.31,-1,93744,2231,32811,3755,75565,22763,81551,59329,12193,34415,"(CONTRACTS OF 12,500,000 JAPANESE YEN)"
02/11/1993,JPY,107.75,0.42%,0.0042,2.31,-1.12,93601,1210,34004,3422,76192,18740,80824,56166,12777,37435,"(CONTRACTS OF 12,500,000 JAPANESE YEN)"
26/10/1993,JPY,108.2,-1.06%,-0.0105,2.34,-0.91,102775,1431,41525,2051,88894,21112,92376,64688,10399,38087,"(CONTRACTS OF 12,500,000 JAPANESE YEN)"
19/10/1993,JPY,107.07,-1.05%,-0.0104,2.37,-0.88,93772,2057,35105,2062,80154,20581,84273,57748,9499,36024,"(CONTRACTS OF 12,500,000 JAPANESE YEN)"
12/10/1993,JPY,105.96,-0.10%,-0.001,2.43,-0.82,65006,2254,15503,1372,49591,21114,53217,37989,11789,27017,"(CONTRACTS OF 12,500,000 JAPANESE YEN)"
05/10/1993,JPY,105.85,-0.82%,-0.0082,2.43,-0.82,60642,2393,15372,429,47460,19819,50282,35620,10360,25022,"(CONTRACTS OF 12,500,000 JAPANESE YEN)"
28/09/1993,JPY,104.99,1.53%,0.0154,2.56,-0.5,59209,4227,13780,253,41171,19908,45651,33941,13558,25268,"(CONTRACTS OF 12,500,000 JAPANESE YEN)"
21/09/1993,JPY,106.62,-0.78%,-0.0077,2.5,-0.56,59291,2766,16438,531,43921,17436,47218,34405,12073,24886,"(CONTRACTS OF 12,500,000 JAPANESE YEN)"
14/09/1993,JPY,105.8,-1.61%,-0.016,2.62,-0.48,84465,5352,13172,122,64836,48730,70310,62024,14155,22441,"(CONTRACTS OF 12,500,000 JAPANESE YEN)"
07/09/1993,JPY,104.12,0.57%,0.0057,2.62,-0.44,86428,17832,12540,2415,44058,50634,64305,65589,22123,20839,"(CONTRACTS OF 12,500,000 JAPANESE YEN)"
31/08/1993,JPY,104.72,-0.97%,-0.0097,2.68,-0.44,82941,26086,10959,2623,31893,50111,60602,63693,22339,19248,"(CONTRACTS OF 12,500,000 JAPANESE YEN)"
24/08/1993,JPY,103.71,-2.70%,-0.0267,2.84,-0.28,81682,28021,10219,2504,27195,48564,57720,61287,23962,20395,"(CONTRACTS OF 12,500,000 JAPANESE YEN)"
17/08/1993,JPY,100.98,3.42%,0.0348,2.87,-0.31,85910,34519,9882,2415,17051,52512,53985,64809,31925,21101,"(CONTRACTS OF 12,500,000 JAPANESE YEN)"
10/08/1993,JPY,104.56,-0.19%,-0.0019,3.18,0.12,77346,29742,9531,1748,18906,47882,50396,59161,26950,18185,"(CONTRACTS OF 12,500,000 JAPANESE YEN)"
03/08/1993,JPY,104.36,1.69%,0.017,3.15,-0.03,78735,32867,7282,1865,14468,51592,49200,60739,29535,17996,"(CONTRACTS OF 12,500,000 JAPANESE YEN)"
27/07/1993,JPY,106.15,1.84%,0.0186,3.18,0,75198,29532,8622,1764,17239,46081,48535,56467,26663,18731,"(CONTRACTS OF 12,500,000 JAPANESE YEN)"
20/07/1993,JPY,108.14,-0.32%,-0.0031,3.18,0.06,71003,20776,10040,1215,28169,39081,50160,50336,20843,20667,"(CONTRACTS OF 12,500,000 JAPANESE YEN)"
13/07/1993,JPY,107.8,1.02%,0.0102,3.18,0,73422,22638,10558,1266,27633,39479,51537,51303,21885,22119,"(CONTRACTS OF 12,500,000 JAPANESE YEN)"
06/07/1993,JPY,108.91,-2.42%,-0.0239,3.15,-0.03,67374,23960,10175,1131,22681,37628,47772,48934,19602,18440,"(CONTRACTS OF 12,500,000 JAPANESE YEN)"
29/06/1993,JPY,106.34,4.12%,0.0421,3.25,0.07,65907,24833,8329,1084,18827,39785,44744,49198,21163,16709,"(CONTRACTS OF 12,500,000 JAPANESE YEN)"
22/06/1993,JPY,110.91,-4.73%,-0.0462,3.18,0,64172,21297,7386,1050,20885,37430,43232,45866,20940,18306,"(CONTRACTS OF 12,500,000 JAPANESE YEN)"
15/06/1993,JPY,105.9,0.22%,0.0022,3.18,0,96625,34555,5362,866,32121,68692,67542,74920,29083,21705,"(CONTRACTS OF 12,500,000 JAPANESE YEN)"
08/06/1993,JPY,106.13,0.72%,0.0072,3.18,0.18,98719,31016,4555,1193,32372,72939,64581,78687,34138,20032,"(CONTRACTS OF 12,500,000 JAPANESE YEN)"
01/06/1993,JPY,106.9,2.11%,0.0213,3.21,0.21,92225,29993,4234,2994,25120,66825,58107,74053,34118,18172,"(CONTRACTS OF 12,500,000 JAPANESE YEN)"
25/05/1993,JPY,109.2,1.98%,0.02,3.25,0.07,89308,30260,3774,2457,24139,65639,56856,71870,32452,17438,"(CONTRACTS OF 12,500,000 JAPANESE YEN)"
18/05/1993,JPY,111.41,-0.05%,-0.0005,3.09,0.09,78349,25068,4021,2449,27288,55028,54805,61498,23544,16851,"(CONTRACTS OF 12,500,000 JAPANESE YEN)"
11/05/1993,JPY,111.35,-1.19%,-0.0118,3.21,0.15,76829,22168,4782,2420,28649,54123,53237,61325,23592,15504,"(CONTRACTS OF 12,500,000 JAPANESE YEN)"
04/05/1993,JPY,110.04,1.64%,0.0166,3.18,0.06,78734,24033,4500,2322,25983,58450,52338,65272,26396,13462,"(CONTRACTS OF 12,500,000 JAPANESE YEN)"
27/04/1993,JPY,111.88,-1.31%,-0.013,3.18,0.12,77016,23965,5088,2325,23964,56123,50254,63536,26762,13480,"(CONTRACTS OF 12,500,000 JAPANESE YEN)"
20/04/1993,JPY,110.43,2.68%,0.0272,3.18,0.06,80388,27736,5206,2339,20269,59636,50344,67181,30044,13207,"(CONTRACTS OF 12,500,000 JAPANESE YEN)"
13/04/1993,JPY,113.47,0.40%,0.004,3.21,0.03,78095,27466,5098,1706,19084,58694,48256,65498,29839,12597,"(CONTRACTS OF 12,500,000 JAPANESE YEN)"
06/04/1993,JPY,113.93,2.25%,0.0227,3.21,0.09,73140,27477,14293,1725,15031,45603,44233,61621,28907,11519,"(CONTRACTS OF 12,500,000 JAPANESE YEN)"
30/03/1993,JPY,116.55,-0.57%,-0.0057,3.28,0.22,68945,24455,14527,2021,15902,43309,42378,59857,26567,9088,"(CONTRACTS OF 12,500,000 JAPANESE YEN)"
23/03/1993,JPY,115.89,0.99%,0.01,3.34,0.16,73225,30784,13728,1327,10111,48886,42222,63941,31003,9284,"(CONTRACTS OF 12,500,000 JAPANESE YEN)"
16/03/1993,JPY,117.05,0.54%,0.0055,3.21,0.09,102504,29646,17120,1873,37249,67721,68768,86714,33736,15790,"(CONTRACTS OF 12,500,000 JAPANESE YEN)"
09/03/1993,JPY,117.69,-0.12%,-0.0012,3.21,0.09,91735,25660,8298,1254,31902,65653,58816,75205,32919,16530,"(CONTRACTS OF 12,500,000 JAPANESE YEN)"
02/03/1993,JPY,117.55,-0.47%,-0.0047,3.25,0.19,86041,28817,9854,2617,21895,62000,53329,74471,32712,11570,"(CONTRACTS OF 12,500,000 JAPANESE YEN)"
23/02/1993,JPY,117,2.48%,0.0251,3.25,0.19,84352,29982,9626,1873,21493,61230,53348,72729,31004,11623,"(CONTRACTS OF 12,500,000 JAPANESE YEN)"
16/02/1993,JPY,119.97,0.97%,0.0098,3.18,0.06,77217,26041,9344,1896,20226,54090,48163,65330,29054,11887,"(CONTRACTS OF 12,500,000 JAPANESE YEN)"
09/02/1993,JPY,121.15,2.78%,0.0282,3.18,0.06,67592,18100,9683,2146,22813,43914,43059,55743,24533,11849,"(CONTRACTS OF 12,500,000 JAPANESE YEN)"
02/02/1993,JPY,124.62,-0.85%,-0.0085,3.31,0.19,49684,6286,10455,2220,27456,24221,35962,36896,13722,12788,"(CONTRACTS OF 12,500,000 JAPANESE YEN)"
26/01/1993,JPY,123.57,1.46%,0.0147,3.5,0.44,50267,5454,11510,2329,28204,23115,35987,36954,14280,13313,"(CONTRACTS OF 12,500,000 JAPANESE YEN)"
19/01/1993,JPY,125.4,-0.14%,-0.0014,3.68,0.53,53223,1793,19493,2109,41752,7440,45654,29042,7569,24181,"(CONTRACTS OF 12,500,000 JAPANESE YEN)"
12/01/1993,JPY,125.22,-0.34%,-0.0034,3.68,0.43,48995,3217,16110,1976,35144,8030,40337,26116,8658,22879,"(CONTRACTS OF 12,500,000 JAPANESE YEN)"
05/01/1993,JPY,124.8,-0.10%,-0.001,3.71,0.46,47748,3961,15311,2053,33857,9071,39871,26435,7877,21313,"(CONTRACTS OF 12,500,000 JAPANESE YEN)"
29/12/1992,JPY,124.68,-0.83%,-0.0083,3.75,0.25,43890,4858,13983,1996,29139,9467,35993,25446,7897,18444,"(CONTRACTS OF 12,500,000 JAPANESE YEN)"
22/12/1992,JPY,123.65,0.23%,0.0023,3.75,0.38,40440,9567,9526,1985,15255,16540,26807,28051,13633,12389,"(CONTRACTS OF 12,500,000 JAPANESE YEN)"
15/12/1992,JPY,123.93,-0.15%,-0.0015,3.75,-0.12,51707,6059,8886,1758,30929,29045,38746,39689,12961,12018,"(CONTRACTS OF 12,500,000 JAPANESE YEN)"
08/12/1992,JPY,123.74,0.29%,0.0029,3.68,0.06,55213,4124,9913,2447,33457,25425,40028,37785,15185,17428,"(CONTRACTS OF 12,500,000 JAPANESE YEN)"
01/12/1992,JPY,124.1,-0.23%,-0.0023,3.68,-0.13,49615,5850,9826,2694,28448,20842,36992,33362,12623,16253,"(CONTRACTS OF 12,500,000 JAPANESE YEN)"
24/11/1992,JPY,123.81,0.41%,0.0041,3.75,0.07,46784,6143,10594,1798,26064,20576,34005,32968,12779,13816,"(CONTRACTS OF 12,500,000 JAPANESE YEN)"
17/11/1992,JPY,124.32,-0.18%,-0.0018,3.71,-0.04,48162,5636,10443,1363,30318,19371,37317,31177,10845,16985,"(CONTRACTS OF 12,500,000 JAPANESE YEN)"
10/11/1992,JPY,124.1,-1.38%,-0.0137,3.71,0.28,43343,8364,10164,0,23193,18086,31557,28250,11786,15093,"(CONTRACTS OF 12,500,000 JAPANESE YEN)"
03/11/1992,JPY,122.41,-0.22%,-0.0022,3.71,0.21,43247,10338,8713,0,17488,21947,27826,30660,15421,12587,"(CONTRACTS OF 12,500,000 JAPANESE YEN)"
27/10/1992,JPY,122.14,0.21%,0.0021,3.71,0.4,44509,12397,7789,0,15403,24350,27800,32139,16709,12370,"(CONTRACTS OF 12,500,000 JAPANESE YEN)"
20/10/1992,JPY,122.4,-1.03%,-0.0103,3.81,0.38,45289,13501,7690,0,14743,25648,28244,33338,17045,11951,"(CONTRACTS OF 12,500,000 JAPANESE YEN)"
13/10/1992,JPY,121.15,-1.25%,-0.0125,3.87,0.56,40308,10347,6692,0,12652,24787,22999,31479,17309,8829,"(CONTRACTS OF 12,500,000 JAPANESE YEN)"
06/10/1992,JPY,119.65,0.13%,0.0013,3.84,0.78,47321,13525,6625,0,12248,32872,25773,39497,21548,7824,"(CONTRACTS OF 12,500,000 JAPANESE YEN)"
30/09/1992,JPY,119.8,0.33%,0.0033,3.87,0.87,45920,13136,7097,0,12902,32477,26038,39574,19882,6346,"(CONTRACTS OF 12,500,000 JAPANESE YEN)"
30/12/2008,EUR,1.4069,0.91%,0.0091,2.84,1.28,120499,32529,35733,1080,49384,56465,82993,93278,37506,27221,"(CONTRACTS OF EUR 125,000)"
22/12/2008,EUR,1.3942,-1.11%,-0.0111,3.02,1.28,118546,30977,34622,1399,49358,56185,81734,92206,36812,26340,"(CONTRACTS OF EUR 125,000)"
16/12/2008,EUR,1.4098,9.19%,0.0879,3,1.18,119389,30798,37424,994,47746,50434,79538,88852,39851,30537,"(CONTRACTS OF EUR 125,000)"
09/12/2008,EUR,1.2912,1.57%,0.0156,3.29,1.24,179318,29347,46015,4056,90454,82700,123857,132771,55461,46547,"(CONTRACTS OF EUR 125,000)"
02/12/2008,EUR,1.2712,-2.64%,-0.0268,3.63,0.3,173018,29631,49828,2383,93058,73945,125072,126156,47946,46862,"(CONTRACTS OF EUR 125,000)"
25/11/2008,EUR,1.3057,3.45%,0.034,3.95,0.51,172366,27389,48867,2687,89976,70266,120052,121820,52314,50546,"(CONTRACTS OF EUR 125,000)"
18/11/2008,EUR,1.2621,0.83%,0.0083,4.08,1.81,165121,29073,46431,2553,86779,63127,118405,112111,46716,53010,"(CONTRACTS OF EUR 125,000)"
11/11/2008,EUR,1.2517,-3.95%,-0.0403,4.36,1.94,170226,25967,46588,2821,92836,63077,121624,112486,48602,57740,"(CONTRACTS OF EUR 125,000)"
04/11/2008,EUR,1.3032,2.51%,0.0248,4.45,2.13,169608,27825,49258,2913,87091,60936,117829,113107,51779,56501,"(CONTRACTS OF EUR 125,000)"
28/10/2008,EUR,1.2713,-2.63%,-0.0267,4.87,1.3,193760,25409,54461,3207,99852,67164,128468,124832,65292,68928,"(CONTRACTS OF EUR 125,000)"
21/10/2008,EUR,1.3057,-4.15%,-0.0424,4.9,1.4,184062,23536,54156,2736,94815,61489,121087,118381,62975,65681,"(CONTRACTS OF EUR 125,000)"
14/10/2008,EUR,1.3622,0.04%,0.0004,4.79,0.31,175810,24274,54374,2574,102280,65951,129128,122899,46682,52911,"(CONTRACTS OF EUR 125,000)"
07/10/2008,EUR,1.3617,-3.44%,-0.035,5.28,0.58,179895,32058,50720,2994,92353,70752,127405,124466,52490,55429,"(CONTRACTS OF EUR 125,000)"
30/09/2008,EUR,1.4102,-3.69%,-0.0376,5.18,0.85,173238,27472,56404,5683,91067,58098,124222,120185,49016,53053,"(CONTRACTS OF EUR 125,000)"
23/09/2008,EUR,1.4643,3.71%,0.0364,4.88,0.8,152022,33266,64323,2058,79367,48721,114691,115102,37331,36920,"(CONTRACTS OF EUR 125,000)"
16/09/2008,EUR,1.4119,-0.11%,-0.0011,4.85,2.13,142148,35314,75968,4720,68208,23682,108242,104370,33906,37778,"(CONTRACTS OF EUR 125,000)"
09/09/2008,EUR,1.4135,-2.62%,-0.0265,4.86,2.01,182828,35890,72322,4300,98579,62462,138769,139084,44059,43744,"(CONTRACTS OF EUR 125,000)"
02/09/2008,EUR,1.4515,-0.91%,-0.0092,4.88,2.02,163458,37997,76620,3701,81688,38194,123386,118515,40072,44943,"(CONTRACTS OF EUR 125,000)"
26/08/2008,EUR,1.4649,-0.93%,-0.0094,4.85,2.1,154444,36026,69804,3328,72360,34980,111714,108112,42730,46332,"(CONTRACTS OF EUR 125,000)"
19/08/2008,EUR,1.4787,-0.88%,-0.0089,4.84,1.93,153468,39958,60322,3660,55286,33789,98904,97771,54564,55697,"(CONTRACTS OF EUR 125,000)"
12/08/2008,EUR,1.4919,-3.47%,-0.0354,4.83,1.98,146235,39822,59249,4152,54139,35030,98113,98431,48122,47804,"(CONTRACTS OF EUR 125,000)"
05/08/2008,EUR,1.5456,-0.85%,-0.0085,4.85,2.02,160311,55538,64985,2778,59169,45026,117485,112789,42826,47522,"(CONTRACTS OF EUR 125,000)"
29/07/2008,EUR,1.5588,-1.24%,-0.0124,4.83,2.12,149933,51585,67803,2528,54512,35374,108625,105705,41308,44228,"(CONTRACTS OF EUR 125,000)"
22/07/2008,EUR,1.5783,-0.85%,-0.0085,4.87,1.99,171505,70588,66517,3238,52550,58424,126376,128179,45129,43326,"(CONTRACTS OF EUR 125,000)"
15/07/2008,EUR,1.5918,1.58%,0.0156,4.9,2.03,183536,85052,62003,3365,45934,78687,134351,144055,49185,39481,"(CONTRACTS OF EUR 125,000)"
08/07/2008,EUR,1.5671,-0.74%,-0.0074,4.83,1.83,176211,81210,57203,2883,44165,69916,128258,130002,47953,46209,"(CONTRACTS OF EUR 125,000)"
01/07/2008,EUR,1.5788,1.43%,0.0142,4.84,2.02,179885,88162,60479,2257,40013,73450,130432,136186,49453,43699,"(CONTRACTS OF EUR 125,000)"
24/06/2008,EUR,1.5565,0.37%,0.0037,4.85,2,147275,57904,56472,2363,38893,49378,99160,108213,48115,39062,"(CONTRACTS OF EUR 125,000)"
17/06/2008,EUR,1.5508,0.30%,0.003,4.91,2.02,132056,49514,58804,2623,32128,27941,84265,89368,47791,42688,"(CONTRACTS OF EUR 125,000)"
10/06/2008,EUR,1.5462,0.12%,0.0012,4.88,2.05,254812,57544,65084,11537,148879,135196,217960,211817,36852,42995,"(CONTRACTS OF EUR 125,000)"
03/06/2008,EUR,1.5444,-1.53%,-0.0154,4.78,2.1,230633,55845,70299,3469,128849,105376,188163,179144,42470,51489,"(CONTRACTS OF EUR 125,000)"
27/05/2008,EUR,1.5684,0.18%,0.0018,4.78,2.14,222241,64503,67893,3506,108565,110485,176574,181884,45667,40357,"(CONTRACTS OF EUR 125,000)"
20/05/2008,EUR,1.5656,1.28%,0.0127,4.75,2.11,212882,70240,63399,3481,94653,104525,168374,171405,44508,41477,"(CONTRACTS OF EUR 125,000)"
13/05/2008,EUR,1.5458,-0.46%,-0.0046,4.78,2.08,207346,55409,64908,3069,106832,98679,165310,166656,42036,40690,"(CONTRACTS OF EUR 125,000)"
06/05/2008,EUR,1.553,-0.24%,-0.0024,4.78,2.01,204066,54383,66895,3628,100580,91173,158591,161696,45475,42370,"(CONTRACTS OF EUR 125,000)"
29/04/2008,EUR,1.5567,-2.63%,-0.0266,4.83,1.93,191308,48319,69634,2219,95786,71281,146324,143134,44984,48174,"(CONTRACTS OF EUR 125,000)"
22/04/2008,EUR,1.5987,1.24%,0.0123,4.76,1.76,178052,81612,62705,3100,41337,63449,126049,129254,52003,48798,"(CONTRACTS OF EUR 125,000)"
15/04/2008,EUR,1.5791,0.58%,0.0058,4.72,1.97,175248,77532,57439,2653,47123,70124,127308,130216,47940,45032,"(CONTRACTS OF EUR 125,000)"
08/04/2008,EUR,1.57,0.58%,0.0058,4.65,1.83,174504,86826,57391,2153,41475,72091,130454,131635,44050,42869,"(CONTRACTS OF EUR 125,000)"
01/04/2008,EUR,1.5609,-0.12%,-0.0012,4.69,1.93,165921,80290,51218,2235,36173,68641,118698,122094,47223,43827,"(CONTRACTS OF EUR 125,000)"
25/03/2008,EUR,1.5627,0.02%,0.0002,4.62,2.03,163586,90956,48185,1636,28157,74502,120749,124323,42837,39263,"(CONTRACTS OF EUR 125,000)"
18/03/2008,EUR,1.5624,1.91%,0.0189,4.51,1.9,162474,78310,51789,2071,34582,65588,114963,119448,47511,43026,"(CONTRACTS OF EUR 125,000)"
11/03/2008,EUR,1.5331,0.81%,0.0081,4.51,1.74,245172,81646,52547,2245,118602,151616,202493,206408,42679,38764,"(CONTRACTS OF EUR 125,000)"
04/03/2008,EUR,1.5208,1.57%,0.0156,4.3,1.43,226280,73238,41228,2592,99752,141064,175582,184884,50698,41396,"(CONTRACTS OF EUR 125,000)"
26/02/2008,EUR,1.4973,1.68%,0.0167,4.21,1.14,217521,75598,43820,1847,88983,128844,166428,174511,51093,43010,"(CONTRACTS OF EUR 125,000)"
19/02/2008,EUR,1.4725,0.98%,0.0098,4.27,1.2,209143,60926,46196,1193,101376,120377,163495,167766,45648,41377,"(CONTRACTS OF EUR 125,000)"
12/02/2008,EUR,1.4582,-0.38%,-0.0038,4.23,1.33,207601,55016,44721,2025,103545,118882,160586,165628,47015,41973,"(CONTRACTS OF EUR 125,000)"
05/02/2008,EUR,1.4637,-0.93%,-0.0094,4.17,1.21,199494,60106,47542,2113,86513,109379,148732,159034,50762,40460,"(CONTRACTS OF EUR 125,000)"
29/01/2008,EUR,1.4775,1.02%,0.0101,4.26,1.02,187780,62078,39622,2407,77332,111456,141817,153485,45963,34295,"(CONTRACTS OF EUR 125,000)"
22/01/2008,EUR,1.4626,-1.22%,-0.0123,4.23,0.91,184289,65581,41836,1313,63634,99499,130528,142648,53761,41641,"(CONTRACTS OF EUR 125,000)"
15/01/2008,EUR,1.4807,0.69%,0.0068,4.42,0.47,177003,81812,36830,1301,42254,102175,125367,140306,51636,36697,"(CONTRACTS OF EUR 125,000)"
08/01/2008,EUR,1.4706,0.80%,0.008,4.47,0.18,179512,85915,34013,1484,41398,108936,128797,144433,50715,35079,"(CONTRACTS OF EUR 125,000)"
31/12/2007,EUR,1.4589,1.33%,0.0132,4.58,-0.15,166421,71697,35042,1248,48525,93036,121470,129326,44951,37095,"(CONTRACTS OF EUR 125,000)"
24/12/2007,EUR,1.4398,-0.07%,-0.0007,4.64,-0.13,157379,68111,37470,1272,44647,87263,114030,126005,43349,31374,"(CONTRACTS OF EUR 125,000)"
18/12/2007,EUR,1.4408,-1.65%,-0.0167,4.65,-0.34,150165,67396,36247,1328,33923,78738,102647,116313,47518,33852,"(CONTRACTS OF EUR 125,000)"
11/12/2007,EUR,1.465,-0.78%,-0.0078,4.88,-0.4,259477,91012,27638,7363,110298,186059,208673,221060,50804,38417,"(CONTRACTS OF EUR 125,000)"
04/12/2007,EUR,1.4765,-0.43%,-0.0043,4.8,-0.39,236107,93659,24542,2827,85243,167434,181729,194803,54378,41304,"(CONTRACTS OF EUR 125,000)"
27/11/2007,EUR,1.4829,0.05%,0.0005,4.56,-0.5,222881,91335,24779,1455,75599,155245,168389,181479,54492,41402,"(CONTRACTS OF EUR 125,000)"
20/11/2007,EUR,1.4821,1.51%,0.015,4.54,-0.36,227240,98548,28520,1433,70157,154389,170138,184342,57102,42898,"(CONTRACTS OF EUR 125,000)"
13/11/2007,EUR,1.4601,0.32%,0.0032,4.51,-0.29,219866,98821,29392,1863,63973,149796,164657,181051,55209,38815,"(CONTRACTS OF EUR 125,000)"
06/11/2007,EUR,1.4554,0.80%,0.008,4.52,-0.29,217765,109002,32954,1777,48039,144656,158818,179387,58947,38378,"(CONTRACTS OF EUR 125,000)"
30/10/2007,EUR,1.4438,1.25%,0.0124,4.54,-0.19,199482,100809,31961,1771,41037,128135,143617,161867,55865,37615,"(CONTRACTS OF EUR 125,000)"
23/10/2007,EUR,1.426,0.70%,0.007,4.55,-0.33,195913,100683,31667,1710,39483,124130,141876,157507,54037,38406,"(CONTRACTS OF EUR 125,000)"
16/10/2007,EUR,1.4161,0.39%,0.0039,4.55,-0.57,208345,116748,30144,1911,32931,141380,151590,173435,56755,34910,"(CONTRACTS OF EUR 125,000)"
09/10/2007,EUR,1.4106,-0.32%,-0.0032,4.55,-0.6,204193,117894,30728,1745,26551,136226,146190,168699,58003,35494,"(CONTRACTS OF EUR 125,000)"
02/10/2007,EUR,1.4151,0.04%,0.0004,4.73,-0.56,214561,132323,37883,1493,24276,137838,158092,177214,56469,37347,"(CONTRACTS OF EUR 125,000)"
25/09/2007,EUR,1.4145,1.18%,0.0117,4.52,-0.72,209652,122295,38847,1808,29894,131573,153997,172228,55655,37424,"(CONTRACTS OF EUR 125,000)"
18/09/2007,EUR,1.398,1.04%,0.0104,4.66,-0.54,203437,123169,37120,1320,25057,136525,149546,174965,53891,28472,"(CONTRACTS OF EUR 125,000)"
11/09/2007,EUR,1.3836,1.70%,0.0168,4.68,-1.03,235169,86476,28262,2429,93096,173688,182001,204379,53168,30790,"(CONTRACTS OF EUR 125,000)"
04/09/2007,EUR,1.3605,0.01%,0.0001,4.69,-1.04,221662,78483,31838,3178,91240,155853,172901,190869,48761,30793,"(CONTRACTS OF EUR 125,000)"
28/08/2007,EUR,1.3603,1.06%,0.0106,4.65,-0.81,221098,74495,31669,5085,98326,152882,177906,189636,43192,31462,"(CONTRACTS OF EUR 125,000)"
21/08/2007,EUR,1.346,-0.55%,-0.0056,4.6,-0.85,216026,74037,35574,5498,88533,147372,168068,188444,47958,27582,"(CONTRACTS OF EUR 125,000)"
14/08/2007,EUR,1.3535,-1.51%,-0.0152,4.44,-1.05,218546,90832,26158,4081,71894,158307,166807,188546,51739,30000,"(CONTRACTS OF EUR 125,000)"
07/08/2007,EUR,1.3742,0.51%,0.0051,4.24,-1.08,227532,111634,32605,2602,53782,161026,168018,196233,59514,31299,"(CONTRACTS OF EUR 125,000)"
31/07/2007,EUR,1.3672,-1.11%,-0.0112,4.21,-1.09,214527,104189,25736,2002,49491,154719,155682,182457,58845,32070,"(CONTRACTS OF EUR 125,000)"
24/07/2007,EUR,1.3826,0.29%,0.0029,4.18,-1.13,225781,126890,30475,2015,31658,162016,160563,194506,65218,31275,"(CONTRACTS OF EUR 125,000)"
17/07/2007,EUR,1.3786,0.30%,0.003,4.13,-1.18,221237,123364,24179,2055,31096,163661,156515,189895,64722,31342,"(CONTRACTS OF EUR 125,000)"
10/07/2007,EUR,1.3745,0.99%,0.0099,4.14,-1.18,223674,129843,26947,1561,27319,157712,158723,186220,64951,37454,"(CONTRACTS OF EUR 125,000)"
03/07/2007,EUR,1.361,1.17%,0.0117,4.11,-1.18,195000,101643,25119,1330,29601,136922,132574,163371,62426,31629,"(CONTRACTS OF EUR 125,000)"
26/06/2007,EUR,1.3452,0.19%,0.0019,4.1,-1.16,183893,92876,25443,688,38856,125552,132420,151683,51473,32210,"(CONTRACTS OF EUR 125,000)"
19/06/2007,EUR,1.3426,0.94%,0.0094,4.09,-1.2,183775,85173,38832,926,47546,113147,133645,152905,50130,30870,"(CONTRACTS OF EUR 125,000)"
12/06/2007,EUR,1.3301,-1.64%,-0.0166,4.08,-1.2,227892,93562,42924,2945,71199,140403,167706,186272,60186,41620,"(CONTRACTS OF EUR 125,000)"
05/06/2007,EUR,1.3523,0.59%,0.0059,4.06,-1.22,214948,119341,34376,2729,33497,136957,155567,174062,59381,40886,"(CONTRACTS OF EUR 125,000)"
29/05/2007,EUR,1.3444,-0.04%,-0.0004,4.03,-1.26,213871,124206,29887,2967,30545,146256,157718,179110,56153,34761,"(CONTRACTS OF EUR 125,000)"
22/05/2007,EUR,1.3449,-1.04%,-0.0104,4.02,-1.24,218897,126860,31573,3132,35859,145736,165851,180441,53046,38456,"(CONTRACTS OF EUR 125,000)"
15/05/2007,EUR,1.359,0.36%,0.0036,3.97,-1.29,236773,146922,27384,2594,28486,170028,178002,200006,58771,36767,"(CONTRACTS OF EUR 125,000)"
08/05/2007,EUR,1.3541,-0.46%,-0.0046,3.98,-1.28,223364,130342,25072,2072,30399,160424,162813,187568,60551,35796,"(CONTRACTS OF EUR 125,000)"
01/05/2007,EUR,1.3603,-0.28%,-0.0028,3.95,-1.31,235249,135399,28711,1056,31403,166590,167858,196357,67391,38892,"(CONTRACTS OF EUR 125,000)"
24/04/2007,EUR,1.3641,0.52%,0.0051,3.93,-1.32,232312,137322,26040,852,26774,166155,164948,193047,67364,39265,"(CONTRACTS OF EUR 125,000)"
17/04/2007,EUR,1.3571,1.00%,0.01,3.91,-1.36,217447,129044,22274,741,22960,158914,152745,181929,64702,35518,"(CONTRACTS OF EUR 125,000)"
10/04/2007,EUR,1.3436,0.77%,0.0077,3.89,-1.37,212087,126947,22553,866,22579,152751,150392,176170,61695,35917,"(CONTRACTS OF EUR 125,000)"
03/04/2007,EUR,1.3333,-0.14%,-0.0014,3.9,-1.35,198368,118379,23301,660,18325,143338,137364,167299,61004,31069,"(CONTRACTS OF EUR 125,000)"
27/03/2007,EUR,1.3352,0.29%,0.0029,3.85,-1.4,192918,116347,22606,654,19438,138232,136439,161492,56479,31426,"(CONTRACTS OF EUR 125,000)"
20/03/2007,EUR,1.3314,0.89%,0.0089,3.85,-1.4,182591,106188,18232,621,18674,135405,125483,154258,57108,28333,"(CONTRACTS OF EUR 125,000)"
13/03/2007,EUR,1.3196,0.54%,0.0054,3.85,-1.4,216699,113009,16854,2314,44465,167858,159788,187026,56911,29673,"(CONTRACTS OF EUR 125,000)"
06/03/2007,EUR,1.3125,-0.87%,-0.0087,3.78,-1.48,201319,107164,18485,2323,36846,152682,146333,173490,54986,27829,"(CONTRACTS OF EUR 125,000)"
27/02/2007,EUR,1.324,0.78%,0.0077,3.77,-1.48,221471,123508,20910,2738,33476,165096,159722,188744,61749,32727,"(CONTRACTS OF EUR 125,000)"
20/02/2007,EUR,1.3138,0.78%,0.0078,3.78,-1.52,202370,117811,18485,2195,27304,150840,147310,171520,55060,30850,"(CONTRACTS OF EUR 125,000)"
13/02/2007,EUR,1.3036,0.43%,0.0043,3.76,-1.54,187086,105371,21576,1668,26385,132507,133424,155751,53662,31335,"(CONTRACTS OF EUR 125,000)"
06/02/2007,EUR,1.298,0.12%,0.0012,3.73,-1.57,182666,74223,28893,1938,51936,117568,128097,148399,54569,34267,"(CONTRACTS OF EUR 125,000)"
30/01/2007,EUR,1.2964,-0.46%,-0.0046,3.73,-1.57,174218,85505,22926,1525,34053,112355,121083,136806,53135,37412,"(CONTRACTS OF EUR 125,000)"
23/01/2007,EUR,1.3024,0.83%,0.0082,3.67,-1.6,169518,77516,16506,1793,34954,115543,114263,133842,55255,35676,"(CONTRACTS OF 125,000 EUROS)"
16/01/2007,EUR,1.2917,-0.61%,-0.0061,3.69,-1.57,164594,67482,13940,2033,31321,108505,100836,124478,63758,40116,"(CONTRACTS OF 125,000 EUROS)"
09/01/2007,EUR,1.2996,-2.11%,-0.0213,3.69,-1.6,183293,93415,18243,1330,28061,132400,122806,151973,60487,31320,"(CONTRACTS OF 125,000 EUROS)"
03/01/2007,EUR,1.3276,1.38%,0.0137,3.67,-1.59,189612,98245,20789,1148,26506,136076,125899,158013,63713,31599,"(CONTRACTS OF 125,000 EUROS)"
26/12/2006,EUR,1.3095,-0.71%,-0.0072,3.66,-1.64,186755,100959,20989,1788,22399,138364,125146,161141,61609,25614,"(CONTRACTS OF 125,000 EUROS)"
19/12/2006,EUR,1.3189,-0.68%,-0.0068,3.65,-1.65,194079,110993,19023,1521,19007,144006,131521,164550,62558,29529,"(CONTRACTS OF 125,000 EUROS)"
12/12/2006,EUR,1.3279,-0.32%,-0.0032,3.62,-1.67,230245,112188,15505,5889,46473,175717,164550,197111,65695,33134,"(CONTRACTS OF 125,000 EUROS)"
05/12/2006,EUR,1.3322,0.92%,0.0091,3.6,-1.68,223733,115201,16936,6365,34887,163201,156453,186502,67280,37231,"(CONTRACTS OF 125,000 EUROS)"
28/11/2006,EUR,1.3201,2.78%,0.0274,3.59,-1.68,207573,107372,17778,5036,33719,142555,146127,165369,61446,42204,"(CONTRACTS OF 125,000 EUROS)"
21/11/2006,EUR,1.2844,0.27%,0.0027,3.57,-1.69,178692,84717,19411,3160,35293,125408,123170,147979,55522,30713,"(CONTRACTS OF 125,000 EUROS)"
14/11/2006,EUR,1.281,0.31%,0.0031,3.55,-1.74,170609,81912,21437,3247,30625,114891,115784,139575,54825,31034,"(CONTRACTS OF 125,000 EUROS)"
07/11/2006,EUR,1.277,0.07%,0.0007,3.53,-1.75,178237,96738,27813,3344,25137,119259,125219,150416,53018,27821,"(CONTRACTS OF 125,000 EUROS)"
31/10/2006,EUR,1.2761,1.64%,0.0163,3.52,-1.75,162230,84563,24515,3478,24644,102923,112685,130916,49545,31314,"(CONTRACTS OF 125,000 EUROS)"
24/10/2006,EUR,1.2555,0.14%,0.0014,3.49,-1.79,158034,70934,43783,2884,38127,70020,111945,116687,46089,41347,"(CONTRACTS OF 125,000 EUROS)"
17/10/2006,EUR,1.2537,0.01%,0.0001,3.46,-1.81,154610,69850,43258,2545,32824,67746,105219,113549,49391,41061,"(CONTRACTS OF 125,000 EUROS)"
10/10/2006,EUR,1.2536,-1.55%,-0.0157,3.44,-1.87,150795,69105,32577,2814,27412,77236,99331,112627,51464,38168,"(CONTRACTS OF 125,000 EUROS)"
03/10/2006,EUR,1.2734,0.40%,0.004,3.4,-1.91,142202,76049,19832,1349,18656,90524,96054,111705,46148,30497,"(CONTRACTS OF 125,000 EUROS)"
26/09/2006,EUR,1.2683,0.05%,0.0005,3.32,-1.97,136955,67422,17480,818,19561,89145,87801,107443,49154,29512,"(CONTRACTS OF 125,000 EUROS)"
19/09/2006,EUR,1.2677,-0.06%,-0.0006,3.31,-2.02,131398,69197,18083,1221,15429,79941,85847,99245,45551,32153,"(CONTRACTS OF 125,000 EUROS)"
12/09/2006,EUR,1.2684,-1.05%,-0.0105,3.27,-2.07,168483,79626,12909,2040,34073,118677,115739,133626,52744,34857,"(CONTRACTS OF 125,000 EUROS)"
05/09/2006,EUR,1.2818,-0.06%,-0.0006,3.23,-2.09,171026,86223,11207,2763,25562,129665,114548,143635,56478,27391,"(CONTRACTS OF 125,000 EUROS)"
29/08/2006,EUR,1.2826,0.18%,0.0018,3.23,-2.11,170168,88423,8786,1654,25123,129589,115200,140029,54968,30139,"(CONTRACTS OF 125,000 EUROS)"
22/08/2006,EUR,1.2803,0.14%,0.0014,3.2,-2.14,175943,89994,8524,799,27222,139078,118015,148401,57928,27542,"(CONTRACTS OF 125,000 EUROS)"
15/08/2006,EUR,1.2785,-0.36%,-0.0036,3.19,-2.16,178761,99050,8846,686,25418,143147,125154,152679,53607,26082,"(CONTRACTS OF 125,000 EUROS)"
08/08/2006,EUR,1.2831,0.03%,0.0003,3.16,-2.23,177763,101133,9025,537,22548,144363,124218,153925,53545,23838,"(CONTRACTS OF 125,000 EUROS)"
01/08/2006,EUR,1.2827,2.00%,0.0198,3.15,-2.27,157856,85072,11643,645,20935,118798,106652,131086,51204,26770,"(CONTRACTS OF 125,000 EUROS)"
25/07/2006,EUR,1.2576,0.57%,0.0057,3.08,-2.35,146454,66687,16386,687,30207,100022,97581,117095,48873,29359,"(CONTRACTS OF 125,000 EUROS)"
18/07/2006,EUR,1.2505,-2.08%,-0.021,3.07,-2.38,152795,67816,16122,449,29176,101106,97441,117677,55354,35118,"(CONTRACTS OF 125,000 EUROS)"
11/07/2006,EUR,1.2771,-0.17%,-0.0017,3.05,-2.41,168069,92291,14396,277,19781,128562,112349,143235,55720,24834,"(CONTRACTS OF 125,000 EUROS)"
03/07/2006,EUR,1.2793,1.67%,0.0166,3.02,-2.41,162104,87088,18543,518,21368,114031,108974,133092,53130,29012,"(CONTRACTS OF 125,000 EUROS)"
27/06/2006,EUR,1.2583,0.00%,0,3.02,-2.44,148166,77942,13272,396,18274,106720,96612,120388,51554,27778,"(CONTRACTS OF 125,000 EUROS)"
20/06/2006,EUR,1.2583,0.32%,0.0032,2.97,-2.41,132604,66017,13527,381,17807,94376,84205,108284,48399,24320,"(CONTRACTS OF 125,000 EUROS)"
13/06/2006,EUR,1.2543,-2.15%,-0.0218,2.91,-2.37,202394,72732,10886,1373,64770,152800,138875,165059,63519,37335,"(CONTRACTS OF 125,000 EUROS)"
06/06/2006,EUR,1.2819,-0.42%,-0.0042,2.92,-2.3,209552,102560,14364,1179,40541,154767,144280,170310,65272,39242,"(CONTRACTS OF 125,000 EUROS)"
30/05/2006,EUR,1.2873,0.42%,0.0042,2.89,-2.29,195502,96864,16980,1246,39005,138891,137115,157117,58387,38385,"(CONTRACTS OF 125,000 EUROS)"
23/05/2006,EUR,1.2819,-0.33%,-0.0033,2.86,-2.29,197806,87361,15285,2317,50079,146064,139757,163666,58049,34140,"(CONTRACTS OF 125,000 EUROS)"
16/05/2006,EUR,1.2861,0.78%,0.0078,2.85,-2.27,195254,87436,14060,1831,45579,143424,134846,159315,60408,35939,"(CONTRACTS OF 125,000 EUROS)"
09/05/2006,EUR,1.2761,1.16%,0.0115,2.83,-2.28,198501,87975,15064,1780,43091,142504,132846,159348,65655,39153,"(CONTRACTS OF 125,000 EUROS)"
02/05/2006,EUR,1.2615,1.46%,0.0145,2.85,-2.25,187074,90615,16141,1346,39152,138150,131113,155637,55961,31437,"(CONTRACTS OF 125,000 EUROS)"
25/04/2006,EUR,1.2434,0.67%,0.0067,2.76,-2.29,177240,79841,14316,713,38061,130344,118615,145373,58625,31867,"(CONTRACTS OF 125,000 EUROS)"
18/04/2006,EUR,1.2351,1.70%,0.0168,2.72,-2.31,165741,70019,14677,1320,38561,118525,109900,134522,55841,31219,"(CONTRACTS OF 125,000 EUROS)"
11/04/2006,EUR,1.2145,-0.89%,-0.0089,2.72,-2.28,159310,58717,17087,2012,46263,110321,106992,129420,52318,29890,"(CONTRACTS OF 125,000 EUROS)"
04/04/2006,EUR,1.2254,2.11%,0.0209,2.79,-2.18,161921,67859,15467,655,43679,113080,112193,129202,49728,32719,"(CONTRACTS OF 125,000 EUROS)"
28/03/2006,EUR,1.2001,-0.72%,-0.0072,2.75,-2.17,140715,56336,15525,810,35558,93460,92704,109795,48011,30920,"(CONTRACTS OF 125,000 EUROS)"
21/03/2006,EUR,1.2088,0.61%,0.0061,2.67,-2.19,141536,58377,16925,485,33700,88412,92562,105822,48974,35714,"(CONTRACTS OF 125,000 EUROS)"
14/03/2006,EUR,1.2015,1.10%,0.011,2.65,-2.21,134870,55058,27074,1435,35565,69607,92058,98116,42812,36754,"(CONTRACTS OF 125,000 EUROS)"
07/03/2006,EUR,1.1884,-0.29%,-0.0029,2.64,-2.15,177395,49877,35999,2590,75783,98478,128250,137067,49145,40328,"(CONTRACTS OF 125,000 EUROS)"
28/02/2006,EUR,1.1919,0.09%,0.0009,2.61,-2.12,159681,50882,32480,1482,56481,82130,108845,116092,50836,43589,"(CONTRACTS OF 125,000 EUROS)"
21/02/2006,EUR,1.1908,-0.05%,-0.0005,2.56,-2.16,151300,42097,32012,1734,58946,75683,102777,109429,48523,41871,"(CONTRACTS OF 125,000 EUROS)"
14/02/2006,EUR,1.1914,-0.49%,-0.0049,2.54,-2.14,140958,43279,31323,1688,50461,69907,95428,102918,45530,38040,"(CONTRACTS OF 125,000 EUROS)"
07/02/2006,EUR,1.1973,-1.49%,-0.015,2.52,-2.12,140121,45622,26657,1662,44620,75293,91904,103612,48217,36509,"(CONTRACTS OF 125,000 EUROS)"
31/01/2006,EUR,1.2154,-1.01%,-0.0102,2.5,-2.18,147953,58564,22182,2382,36469,89459,97415,114023,50538,33930,"(CONTRACTS OF 125,000 EUROS)"
24/01/2006,EUR,1.2278,1.43%,0.0142,2.45,-2.09,144608,56834,19370,3315,33491,89341,93640,112026,50968,32582,"(CONTRACTS OF 125,000 EUROS)"
17/01/2006,EUR,1.2105,0.32%,0.0032,2.46,-2.11,129565,41207,19996,2730,36151,69669,80088,92395,49477,37170,"(CONTRACTS OF 125,000 EUROS)"
10/01/2006,EUR,1.2066,0.46%,0.0046,2.43,-2.1,127386,42096,20135,2455,34870,63074,79421,85664,47965,41722,"(CONTRACTS OF 125,000 EUROS)"
03/01/2006,EUR,1.2011,1.55%,0.0154,2.43,-2.1,119238,36013,24782,2420,36844,48533,75277,75735,43961,43503,"(CONTRACTS OF 125,000 EUROS)"
27/12/2005,EUR,1.1828,-0.34%,-0.0034,2.44,-2.07,112370,25937,21359,2384,44261,50356,72582,74099,39788,38271,"(CONTRACTS OF 125,000 EUROS)"
20/12/2005,EUR,1.1868,-0.57%,-0.0057,2.44,-2.04,123445,24852,20348,2443,50514,58508,77809,81299,45636,42146,"(CONTRACTS OF 125,000 EUROS)"
13/12/2005,EUR,1.1936,1.28%,0.0127,2.4,-2,192392,28088,29151,2760,117671,114350,148519,146261,43873,46131,"(CONTRACTS OF 125,000 EUROS)"
06/12/2005,EUR,1.1785,0.02%,0.0002,2.4,-1.98,179353,28784,51356,3376,103103,79708,135263,134440,44090,44913,"(CONTRACTS OF 125,000 EUROS)"
29/11/2005,EUR,1.1783,-0.24%,-0.0024,2.4,-1.93,182131,30467,48599,3052,101892,83991,135411,135642,46720,46489,"(CONTRACTS OF 125,000 EUROS)"
22/11/2005,EUR,1.1811,0.79%,0.0079,2.41,-1.92,185618,35452,46579,3216,97074,80164,135742,129959,49876,55659,"(CONTRACTS OF 125,000 EUROS)"
15/11/2005,EUR,1.1718,-0.52%,-0.0052,2.3,-1.99,175265,31487,44709,2096,94478,73806,128061,120611,47204,54654,"(CONTRACTS OF 125,000 EUROS)"
08/11/2005,EUR,1.1779,-1.92%,-0.0193,2.25,-2.01,159878,29558,36185,1375,81207,68774,112140,106334,47738,53544,"(CONTRACTS OF 125,000 EUROS)"
01/11/2005,EUR,1.2009,-0.84%,-0.0085,2.22,-1.99,144306,26432,19434,918,73569,75190,100919,95542,43387,48764,"(CONTRACTS OF 125,000 EUROS)"
25/10/2005,EUR,1.2111,1.27%,0.0126,2.15,-2.01,151243,20794,23352,1672,77812,70441,100278,95465,50965,55778,"(CONTRACTS OF 125,000 EUROS)"
18/10/2005,EUR,1.1959,-0.26%,-0.0026,2.12,-1.98,144421,25238,24383,763,73072,68315,99073,93461,45348,50960,"(CONTRACTS OF 125,000 EUROS)"
11/10/2005,EUR,1.199,0.62%,0.0062,2.13,-1.92,130998,30103,25311,1245,61280,58641,92628,85197,38370,45801,"(CONTRACTS OF 125,000 EUROS)"
04/10/2005,EUR,1.1916,-0.82%,-0.0083,2.11,-1.91,143338,34646,36544,812,68778,56196,104236,93552,39102,49786,"(CONTRACTS OF 125,000 EUROS)"
27/09/2005,EUR,1.2015,-0.83%,-0.0083,2.05,-1.88,135698,32927,34530,1192,64263,56575,98382,92297,37316,43401,"(CONTRACTS OF 125,000 EUROS)"
20/09/2005,EUR,1.2115,-1.21%,-0.0121,2.08,-1.79,118666,29052,30480,832,52941,47456,82825,78768,35841,39898,"(CONTRACTS OF 125,000 EUROS)"
13/09/2005,EUR,1.2263,-1.57%,-0.0159,2.08,-1.68,162743,29321,21736,1594,88697,101633,119612,124963,43131,37780,"(CONTRACTS OF 125,000 EUROS)"
06/09/2005,EUR,1.2459,1.98%,0.0196,2.08,-1.61,161018,38768,15250,1007,80291,109602,120066,125859,40952,35159,"(CONTRACTS OF 125,000 EUROS)"
30/08/2005,EUR,1.2217,-0.11%,-0.0011,2.08,-1.68,153731,26465,30084,1169,90759,88098,118393,119351,35338,34380,"(CONTRACTS OF 125,000 EUROS)"
23/08/2005,EUR,1.223,-1.07%,-0.0107,2.08,-1.7,145089,24238,30004,1018,77787,73001,103043,104023,42046,41066,"(CONTRACTS OF 125,000 EUROS)"
16/08/2005,EUR,1.2362,-0.06%,-0.0006,2.08,-1.66,148418,27289,26705,911,73571,77537,101771,105153,46647,43265,"(CONTRACTS OF 125,000 EUROS)"
09/08/2005,EUR,1.2369,1.40%,0.0139,2.1,-1.59,145759,28507,24276,1148,70541,74659,100196,100083,45563,45676,"(CONTRACTS OF 125,000 EUROS)"
02/08/2005,EUR,1.2198,1.57%,0.0155,2.1,-1.56,143594,24408,24599,626,72783,74601,97817,99826,45777,43768,"(CONTRACTS OF 125,000 EUROS)"
26/07/2005,EUR,1.201,-0.19%,-0.0019,2.09,-1.53,144785,24520,32816,651,71960,64853,97131,98320,47654,46465,"(CONTRACTS OF 125,000 EUROS)"
19/07/2005,EUR,1.2033,-1.68%,-0.017,2.09,-1.48,143052,23055,34925,293,74964,60278,98312,95496,44740,47556,"(CONTRACTS OF 125,000 EUROS)"
12/07/2005,EUR,1.2239,2.75%,0.0271,2.08,-1.46,140286,24267,32115,485,72930,59128,97682,91728,42604,48558,"(CONTRACTS OF 125,000 EUROS)"
05/07/2005,EUR,1.1912,-1.22%,-0.0123,2.1,-1.43,148960,23019,47891,1693,73540,46146,98252,95730,50708,53230,"(CONTRACTS OF 125,000 EUROS)"
28/06/2005,EUR,1.2059,-0.97%,-0.0097,2.06,-1.35,139172,31816,46057,1572,62859,46580,96247,94209,42925,44963,"(CONTRACTS OF 125,000 EUROS)"
21/06/2005,EUR,1.2177,1.26%,0.0125,2.09,-1.34,142566,26061,47343,1652,69289,44387,97002,93382,45564,49184,"(CONTRACTS OF 125,000 EUROS)"
14/06/2005,EUR,1.2026,-2.09%,-0.0211,2.07,-1.28,140233,26335,46000,1613,65262,42453,93210,90066,47023,50167,"(CONTRACTS OF 125,000 EUROS)"
07/06/2005,EUR,1.2283,-0.21%,-0.0021,2.02,-1.28,193707,22939,40710,629,125244,105308,148812,146647,44895,47060,"(CONTRACTS OF 125,000 EUROS)"
31/05/2005,EUR,1.2309,-2.13%,-0.0215,2.07,-1.2,190494,24211,42521,1043,103595,83901,128849,127465,61645,63029,"(CONTRACTS OF 125,000 EUROS)"
24/05/2005,EUR,1.2577,-0.20%,-0.002,2.11,-1.08,162145,24631,39952,1274,92321,68523,118226,109749,43919,52396,"(CONTRACTS OF 125,000 EUROS)"
17/05/2005,EUR,1.2602,-2.17%,-0.0219,2.07,-1.1,156860,22232,35720,1058,88051,69952,111341,106730,45519,50130,"(CONTRACTS OF 125,000 EUROS)"
10/05/2005,EUR,1.2881,0.11%,0.0011,2.08,-1.1,148731,27335,28879,750,73185,70847,101270,100476,47461,48255,"(CONTRACTS OF 125,000 EUROS)"
03/05/2005,EUR,1.2867,-0.93%,-0.0094,2.07,-1.06,138018,26070,21195,563,65969,73021,92602,94779,45416,43239,"(CONTRACTS OF 125,000 EUROS)"
26/04/2005,EUR,1.2988,-0.52%,-0.0052,2.07,-1.03,133030,23524,19305,1194,63574,69751,88292,90250,44738,42780,"(CONTRACTS OF 125,000 EUROS)"
19/04/2005,EUR,1.3056,1.04%,0.0104,2.08,-0.94,118581,23613,18592,357,54810,65542,78780,84491,39801,34090,"(CONTRACTS OF 125,000 EUROS)"
12/04/2005,EUR,1.2921,0.51%,0.005,2.09,-1,131025,30092,24332,522,58423,68977,89037,93831,41988,37194,"(CONTRACTS OF 125,000 EUROS)"
05/04/2005,EUR,1.2856,-0.50%,-0.005,2.13,-0.88,126079,26469,19571,192,53567,60949,80228,80712,45851,45367,"(CONTRACTS OF 125,000 EUROS)"
29/03/2005,EUR,1.292,-1.26%,-0.0127,2.113,-0.93,116888,30250,12497,218,39394,63903,69862,76618,47026,40270,"(CONTRACTS OF 125,000 EUROS)"
22/03/2005,EUR,1.3085,-1.65%,-0.0167,2.106,-0.85,115071,36967,9768,183,27075,63385,64225,73336,50846,41735,"(CONTRACTS OF 125,000 EUROS)"
15/03/2005,EUR,1.3305,-0.28%,-0.0028,2.08,-0.86,122371,42647,12735,227,26959,68607,69833,81569,52538,40802,"(CONTRACTS OF 125,000 EUROS)"
08/03/2005,EUR,1.3342,1.20%,0.0119,2.09,-0.76,169161,37116,14526,550,70109,108157,107775,123233,61386,45928,"(CONTRACTS OF 125,000 EUROS)"
01/03/2005,EUR,1.3184,-0.49%,-0.0049,2.08,-0.77,169942,46880,13462,1179,60219,108439,108278,123080,61664,46862,"(CONTRACTS OF 125,000 EUROS)"
22/02/2005,EUR,1.3249,1.77%,0.0176,2.08,-0.75,164961,29004,24980,1616,70354,79321,100974,105917,63987,59044,"(CONTRACTS OF 125,000 EUROS)"
15/02/2005,EUR,1.3018,1.97%,0.0195,2.08,-0.66,148131,28112,28357,818,68660,71807,97590,100982,50541,47149,"(CONTRACTS OF 125,000 EUROS)"
08/02/2005,EUR,1.2766,-2.09%,-0.0212,2.15,-0.54,152377,26185,26816,708,63001,70153,89894,97677,62483,54700,"(CONTRACTS OF 125,000 EUROS)"
01/02/2005,EUR,1.3039,0.52%,0.0052,2.09,-0.62,129210,25980,24055,530,57821,64246,84331,88831,44879,40379,"(CONTRACTS OF 125,000 EUROS)"
25/01/2005,EUR,1.2972,-0.41%,-0.0042,2.08,-0.56,131203,25401,24633,574,56009,61407,81984,86614,49219,44589,"(CONTRACTS OF 125,000 EUROS)"
18/01/2005,EUR,1.3026,-0.66%,-0.0066,2.09,-0.51,131661,28380,18467,889,44413,62300,73682,81656,57979,50005,"(CONTRACTS OF 125,000 EUROS)"
11/01/2005,EUR,1.3112,-1.19%,-0.012,2.09,-0.48,143785,33414,17233,570,38897,68858,72881,86661,70904,57124,"(CONTRACTS OF 125,000 EUROS)"
04/01/2005,EUR,1.327,-2.48%,-0.0252,2.11,-0.41,141191,35806,24735,1315,37380,63543,74501,89593,66690,51598,"(CONTRACTS OF 125,000 EUROS)"
28/12/2004,EUR,1.3608,1.79%,0.0177,2.13,-0.33,147687,44526,27712,1347,42625,65999,88498,95058,59189,52629,"(CONTRACTS OF 125,000 EUROS)"
21/12/2004,EUR,1.3369,0.50%,0.005,2.12,-0.34,147150,39467,51631,997,48636,46674,89100,99302,58050,47848,"(CONTRACTS OF 125,000 EUROS)"
14/12/2004,EUR,1.3302,-0.92%,-0.0092,2.12,-0.29,136413,36764,51306,537,46052,41269,83353,93112,53060,43301,"(CONTRACTS OF 125,000 EUROS)"
07/12/2004,EUR,1.3425,1.01%,0.01,2.12,-0.25,223808,57209,33095,1379,83513,136066,142101,170540,81707,53268,"(CONTRACTS OF 125,000 EUROS)"
30/11/2004,EUR,1.3291,1.61%,0.016,2.11,-0.23,233254,61453,36968,1346,82034,140039,144833,178353,88421,54901,"(CONTRACTS OF 125,000 EUROS)"
23/11/2004,EUR,1.308,0.96%,0.0095,2.12,-0.16,233859,66849,34588,782,81674,148495,149305,183865,84554,49994,"(CONTRACTS OF 125,000 EUROS)"
16/11/2004,EUR,1.2956,0.49%,0.0049,2.11,-0.13,203471,66875,12847,756,63861,139153,131492,152756,71979,50715,"(CONTRACTS OF 125,000 EUROS)"
09/11/2004,EUR,1.2893,1.32%,0.0131,2.12,-0.09,185582,68576,11047,441,52277,134586,121294,146074,64288,39508,"(CONTRACTS OF 125,000 EUROS)"
02/11/2004,EUR,1.2725,-0.22%,-0.0022,2.1,0,158411,60468,7003,163,35031,117092,95662,124258,62749,34153,"(CONTRACTS OF 125,000 EUROS)"
26/10/2004,EUR,1.2753,1.90%,0.0188,2.09,0.05,150482,50767,5236,166,39054,109011,89987,114413,60495,36069,"(CONTRACTS OF 125,000 EUROS)"
19/10/2004,EUR,1.2515,1.60%,0.0159,2.09,0.09,130386,43487,6975,115,32689,89593,76291,96683,54095,33703,"(CONTRACTS OF 125,000 EUROS)"
12/10/2004,EUR,1.2318,0.07%,0.0007,2.11,0.14,132397,44461,6366,65,35406,98103,79932,104534,52465,27863,"(CONTRACTS OF 125,000 EUROS)"
05/10/2004,EUR,1.2309,-0.11%,-0.0011,2.1,0.13,132300,50305,5494,275,33621,99613,84201,105382,48099,26918,"(CONTRACTS OF 125,000 EUROS)"
28/09/2004,EUR,1.2323,-0.04%,-0.0004,2.06,0.19,107544,36015,3681,69,27731,74935,63815,78685,43729,28859,"(CONTRACTS OF 125,000 EUROS)"
21/09/2004,EUR,1.2328,0.67%,0.0067,2.06,0.22,91424,32698,7251,66,16077,55318,48841,62635,42583,28789,"(CONTRACTS OF 125,000 EUROS)"
14/09/2004,EUR,1.2246,1.17%,0.0117,2.06,0.27,90696,30651,4793,155,17920,58386,48726,63334,41970,27362,"(CONTRACTS OF 125,000 EUROS)"
07/09/2004,EUR,1.2104,-0.66%,-0.0067,2.02,0.27,168870,27671,9639,353,81065,125572,109089,135564,59781,33306,"(CONTRACTS OF 125,000 EUROS)"
31/08/2004,EUR,1.2185,0.86%,0.0086,2.02,0.31,171325,29212,8385,481,81711,130509,111404,139375,59921,31950,"(CONTRACTS OF 125,000 EUROS)"
24/08/2004,EUR,1.2081,-2.19%,-0.0221,2.06,0.42,164966,28134,3518,146,76606,131663,104886,135327,60080,29639,"(CONTRACTS OF 125,000 EUROS)"
17/08/2004,EUR,1.2351,1.05%,0.0104,2.06,0.34,154281,30307,4608,102,74620,123949,105029,128659,49252,25622,"(CONTRACTS OF 125,000 EUROS)"
10/08/2004,EUR,1.2223,1.44%,0.0143,2.11,0.44,154249,24370,7513,385,84712,116842,109467,124740,44782,29509,"(CONTRACTS OF 125,000 EUROS)"
03/08/2004,EUR,1.205,-0.02%,-0.0002,2.15,0.44,156968,22799,10557,229,87698,115517,110726,126303,46242,30665,"(CONTRACTS OF 125,000 EUROS)"
27/07/2004,EUR,1.2053,-2.22%,-0.0225,2.06,0.49,137974,25479,8552,219,64008,97792,89706,106563,48268,31411,"(CONTRACTS OF 125,000 EUROS)"
20/07/2004,EUR,1.2327,-0.02%,-0.0002,2.06,0.54,145213,43666,7565,254,50330,106280,94250,114099,50963,31114,"(CONTRACTS OF 125,000 EUROS)"
13/07/2004,EUR,1.233,0.37%,0.0037,2.06,0.54,147585,39391,8379,466,58143,108543,98000,117388,49585,30197,"(CONTRACTS OF 125,000 EUROS)"
06/07/2004,EUR,1.2285,1.72%,0.0171,2.06,0.54,125199,27466,8429,49,49622,87848,77137,96326,48062,28873,"(CONTRACTS OF 125,000 EUROS)"
29/06/2004,EUR,1.2077,-0.27%,-0.0027,2.08,0.54,106582,22478,8723,667,43577,71109,66722,80499,39860,26083,"(CONTRACTS OF 125,000 EUROS)"
22/06/2004,EUR,1.211,-0.40%,-0.004,2.07,0.61,92563,21435,9356,197,31374,58131,53006,67684,39557,24879,"(CONTRACTS OF 125,000 EUROS)"
15/06/2004,EUR,1.2159,-0.82%,-0.0083,2.07,0.6,85653,23114,6526,197,21216,53066,44527,59789,41126,25864,"(CONTRACTS OF 125,000 EUROS)"
08/06/2004,EUR,1.226,0.11%,0.0011,2.01,0.68,159172,33175,9701,448,76675,120564,110298,130713,48874,28459,"(CONTRACTS OF 125,000 EUROS)"
01/06/2004,EUR,1.2246,1.26%,0.0125,2.01,0.8,159590,30690,8496,574,73410,114256,104674,123326,54916,36264,"(CONTRACTS OF 125,000 EUROS)"
25/05/2004,EUR,1.2094,1.17%,0.0116,2.03,0.79,148621,26589,7875,39,76254,100069,102882,107983,45739,40638,"(CONTRACTS OF 125,000 EUROS)"
18/05/2004,EUR,1.1954,0.67%,0.0067,2.01,0.85,145574,22806,9384,41,78479,97371,101326,106796,44248,38778,"(CONTRACTS OF 125,000 EUROS)"
11/05/2004,EUR,1.1874,-1.94%,-0.0196,2,0.86,127408,23484,11006,111,60552,79472,84147,90589,43261,36819,"(CONTRACTS OF 125,000 EUROS)"
04/05/2004,EUR,1.2109,1.52%,0.0151,1.99,0.92,124170,19501,12502,285,62692,72433,82478,85220,41692,38950,"(CONTRACTS OF 125,000 EUROS)"
27/04/2004,EUR,1.1928,0.60%,0.006,2.01,0.94,119710,19136,13566,430,58644,68137,78210,82133,41500,37577,"(CONTRACTS OF 125,000 EUROS)"
20/04/2004,EUR,1.1857,-0.72%,-0.0072,1.97,0.89,114818,22037,12238,115,51488,65820,73640,78173,41178,36645,"(CONTRACTS OF 125,000 EUROS)"
12/04/2004,EUR,1.1943,-1.39%,-0.014,1.97,0.93,109077,18074,12331,102,49513,62828,67689,75261,41388,33816,"(CONTRACTS OF 125,000 EUROS)"
06/04/2004,EUR,1.2111,-0.45%,-0.0045,1.96,0.93,107414,18589,12572,102,46112,57921,64803,70595,42611,36819,"(CONTRACTS OF 125,000 EUROS)"
30/03/2004,EUR,1.2166,-1.31%,-0.0131,1.9,0.9,100890,17155,10981,135,43769,57032,61059,68148,39831,32742,"(CONTRACTS OF 125,000 EUROS)"
23/03/2004,EUR,1.2327,0.52%,0.0052,1.94,0.93,95616,18389,8096,144,36503,58796,55036,67036,40580,28580,"(CONTRACTS OF 125,000 EUROS)"
16/03/2004,EUR,1.2263,-0.44%,-0.0044,1.97,0.95,87390,17522,9068,86,28626,48552,46234,57706,41156,29684,"(CONTRACTS OF 125,000 EUROS)"
09/03/2004,EUR,1.2317,0.79%,0.0078,2.07,1.08,142361,24065,10000,619,71601,97855,96285,108474,46076,33887,"(CONTRACTS OF 125,000 EUROS)"
02/03/2004,EUR,1.2221,-3.65%,-0.0372,1.97,0.96,135662,24451,7423,776,62136,94594,87363,102793,48299,32869,"(CONTRACTS OF 125,000 EUROS)"
24/02/2004,EUR,1.2684,-1.18%,-0.0119,1.99,0.98,133504,31780,5413,589,54642,94386,87011,100388,46493,33116,"(CONTRACTS OF 125,000 EUROS)"
17/02/2004,EUR,1.2836,1.13%,0.0112,1.99,0.99,145315,35758,7349,336,54490,102550,90584,110235,54731,35080,"(CONTRACTS OF 125,000 EUROS)"
10/02/2004,EUR,1.2693,1.30%,0.0129,2.02,0.98,128407,33820,7578,284,45495,90863,79599,98725,48808,29682,"(CONTRACTS OF 125,000 EUROS)"
03/02/2004,EUR,1.253,-0.86%,-0.0087,2.04,1,124312,31305,10859,448,47942,84663,79695,95970,44617,28342,"(CONTRACTS OF 125,000 EUROS)"
27/01/2004,EUR,1.2639,0.49%,0.0049,2.03,1,129170,36682,3384,1084,42527,92411,80293,96879,48877,32291,"(CONTRACTS OF 125,000 EUROS)"
20/01/2004,EUR,1.2577,-1.47%,-0.0148,2.03,0.99,129548,35293,7050,682,44234,88583,80209,96315,49339,33233,"(CONTRACTS OF 125,000 EUROS)"
13/01/2004,EUR,1.2764,0.27%,0.0027,2.03,0.99,130510,35894,8957,245,40431,90936,76570,100138,53940,30372,"(CONTRACTS OF 125,000 EUROS)"
06/01/2004,EUR,1.2729,1.44%,0.0143,2.01,0.95,126442,36578,6668,101,37420,86242,74099,93011,52343,33431,"(CONTRACTS OF 125,000 EUROS)"
30/12/2003,EUR,1.2548,1.32%,0.0131,2.04,0.99,119095,38530,4974,16,33190,85465,71736,90455,47359,28640,"(CONTRACTS OF 125,000 EUROS)"
22/12/2003,EUR,1.2385,0.53%,0.0053,2.09,1,118490,38595,4887,16,31053,85352,69664,90255,48826,28235,"(CONTRACTS OF 125,000 EUROS)"
16/12/2003,EUR,1.232,0.47%,0.0047,2.09,1,119162,39854,5071,613,28939,85043,69406,90727,49756,28435,"(CONTRACTS OF 125,000 EUROS)"
09/12/2003,EUR,1.2262,1.46%,0.0145,2.07,1,152632,33513,5515,204,63614,109882,97331,115601,55301,37031,"(CONTRACTS OF 125,000 EUROS)"
02/12/2003,EUR,1.2085,2.55%,0.0252,2.08,1.01,135551,35337,4657,118,41775,96997,77230,101772,58321,33779,"(CONTRACTS OF 125,000 EUROS)"
25/11/2003,EUR,1.1784,-1.46%,-0.0147,2.07,1.03,122880,33819,3322,569,34228,90331,68616,94222,54264,28658,"(CONTRACTS OF 125,000 EUROS)"
18/11/2003,EUR,1.1959,3.93%,0.0385,2.07,1,125596,37534,2988,1082,31787,87711,70403,91781,55193,33815,"(CONTRACTS OF 125,000 EUROS)"
11/11/2003,EUR,1.1507,0.04%,0.0004,2.08,1.02,102826,21264,3345,495,33138,73291,54897,77131,47929,25695,"(CONTRACTS OF 125,000 EUROS)"
04/11/2003,EUR,1.1502,-1.39%,-0.014,2.11,1.06,98943,21858,2285,127,30611,71620,52596,74032,46347,24911,"(CONTRACTS OF 125,000 EUROS)"
28/10/2003,EUR,1.1664,-0.04%,-0.0004,2.07,1.01,102842,28893,4688,87,22558,75056,51538,79831,51304,23011,"(CONTRACTS OF 125,000 EUROS)"
21/10/2003,EUR,1.1669,-0.57%,-0.0057,2.07,1.02,106515,28987,4874,15,26125,76465,55127,81354,51388,25161,"(CONTRACTS OF 125,000 EUROS)"
14/10/2003,EUR,1.1736,-0.25%,-0.0026,2.06,1.02,105915,29854,4860,50,21711,75716,51615,80626,54300,25289,"(CONTRACTS OF 125,000 EUROS)"
07/10/2003,EUR,1.1766,0.93%,0.0092,2.05,1.02,96823,25794,5769,50,19886,65167,45730,70986,51093,25837,"(CONTRACTS OF 125,000 EUROS)"
30/09/2003,EUR,1.1658,1.88%,0.0186,2.05,1.02,91864,18650,5001,340,18884,58731,37874,64072,53990,27792,"(CONTRACTS OF 125,000 EUROS)"
23/09/2003,EUR,1.1443,2.38%,0.0235,2.06,1.03,82549,15340,6563,622,21389,53635,37351,60820,45198,21729,"(CONTRACTS OF 125,000 EUROS)"
16/09/2003,EUR,1.1177,-0.43%,-0.0043,2.06,1.03,80591,11847,7123,492,28498,50958,40837,58573,39754,22018,"(CONTRACTS OF 125,000 EUROS)"
09/09/2003,EUR,1.1225,3.86%,0.0379,2.07,1.03,114940,13438,10933,1437,53083,69694,67958,82064,46982,32876,"(CONTRACTS OF 125,000 EUROS)"
02/09/2003,EUR,1.0808,-0.41%,-0.0042,2.06,1.01,107173,14372,12243,1221,47245,63189,62838,76653,44335,30520,"(CONTRACTS OF 125,000 EUROS)"
26/08/2003,EUR,1.0853,-2.59%,-0.0263,2.06,1.05,100114,14690,12017,849,40446,59159,55985,72025,44129,28089,"(CONTRACTS OF 125,000 EUROS)"
19/08/2003,EUR,1.1142,-1.20%,-0.012,2.06,1.04,95786,16930,7809,713,37631,60069,55274,68591,40512,27195,"(CONTRACTS OF 125,000 EUROS)"
12/08/2003,EUR,1.1277,-1.03%,-0.0103,2.05,1.02,97523,18505,3803,1211,36733,72336,56449,77350,41074,20173,"(CONTRACTS OF 125,000 EUROS)"
05/08/2003,EUR,1.1394,-0.32%,-0.0032,2.06,1.04,93299,16777,2888,1298,35466,69227,53541,73413,39758,19886,"(CONTRACTS OF 125,000 EUROS)"
29/07/2003,EUR,1.1431,0.93%,0.0092,2.04,1.01,96272,17608,5188,1266,34149,68502,53023,74956,43249,21316,"(CONTRACTS OF 125,000 EUROS)"
22/07/2003,EUR,1.1326,1.36%,0.0135,2.04,1.03,96459,18266,5113,715,38271,67483,57252,73311,39207,23148,"(CONTRACTS OF 125,000 EUROS)"
15/07/2003,EUR,1.1174,-1.28%,-0.0129,2.05,1.05,99175,22847,6652,607,33860,65327,57314,72586,41861,26589,"(CONTRACTS OF 125,000 EUROS)"
08/07/2003,EUR,1.1319,-2.09%,-0.0212,2.06,1.05,94616,25188,6027,309,26694,66038,52191,72374,42425,22242,"(CONTRACTS OF 125,000 EUROS)"
01/07/2003,EUR,1.1561,0.45%,0.0045,2.04,1.03,101717,28532,4902,185,25643,71594,54360,76681,47357,25036,"(CONTRACTS OF 125,000 EUROS)"
24/06/2003,EUR,1.1509,-2.33%,-0.0235,2.06,1.18,94856,27814,4344,275,22540,69143,50629,73762,44227,21094,"(CONTRACTS OF 125,000 EUROS)"
17/06/2003,EUR,1.1783,0.96%,0.0096,2.06,1.13,103252,33888,5765,574,19724,73401,54186,79740,49066,23512,"(CONTRACTS OF 125,000 EUROS)"
10/06/2003,EUR,1.1671,-0.47%,-0.0047,2.05,1.01,136383,32439,6177,852,48533,97488,81824,104517,54559,31866,"(CONTRACTS OF 125,000 EUROS)"
03/06/2003,EUR,1.1726,-0.71%,-0.0071,2.13,0.96,115440,35738,5705,335,28438,82589,64511,88629,50929,26811,"(CONTRACTS OF 125,000 EUROS)"
27/05/2003,EUR,1.181,0.82%,0.0082,2.22,1.02,110029,31242,7129,801,26381,69677,58424,77607,51605,32422,"(CONTRACTS OF 125,000 EUROS)"
20/05/2003,EUR,1.1714,1.68%,0.0167,2.26,1.14,108716,30918,4020,1259,24360,74601,56537,79880,52179,28836,"(CONTRACTS OF 125,000 EUROS)"
13/05/2003,EUR,1.152,0.72%,0.0071,2.34,1.16,100930,28679,3776,277,22984,66704,51940,70757,48990,30173,"(CONTRACTS OF 125,000 EUROS)"
06/05/2003,EUR,1.1438,3.30%,0.0324,2.45,1.31,115082,34554,2584,137,29230,81472,63921,84193,51161,30889,"(CONTRACTS OF 125,000 EUROS)"
29/04/2003,EUR,1.1073,0.95%,0.0094,2.45,1.23,103869,31023,3018,166,23951,74592,55140,77776,48729,26093,"(CONTRACTS OF 125,000 EUROS)"
22/04/2003,EUR,1.0969,1.62%,0.0161,2.47,1.26,95982,27788,3401,204,25211,68091,53203,71696,42779,24286,"(CONTRACTS OF 125,000 EUROS)"
15/04/2003,EUR,1.0794,0.78%,0.0078,2.47,1.24,77639,16934,2729,100,24520,54713,41554,57542,36085,20097,"(CONTRACTS OF 125,000 EUROS)"
08/04/2003,EUR,1.071,-1.82%,-0.0184,2.42,1.26,71412,15619,2474,100,19364,48155,35083,50729,36329,20683,"(CONTRACTS OF 125,000 EUROS)"
01/04/2003,EUR,1.0909,2.44%,0.0241,2.41,1.27,75951,16707,6143,153,22378,50451,39238,56747,36713,19204,"(CONTRACTS OF 125,000 EUROS)"
25/03/2003,EUR,1.0649,0.17%,0.0017,2.44,1.24,72434,16336,8742,41,24956,47292,41333,56075,31101,16359,"(CONTRACTS OF 125,000 EUROS)"
18/03/2003,EUR,1.0631,-3.71%,-0.0378,2.49,1.32,78765,18948,5609,291,22407,55066,41646,60966,37119,17799,"(CONTRACTS OF 125,000 EUROS)"
11/03/2003,EUR,1.1041,1.40%,0.0139,2.47,1.36,136246,35344,5078,426,48407,105656,84177,111160,52069,25086,"(CONTRACTS OF 125,000 EUROS)"
04/03/2003,EUR,1.0889,1.23%,0.0122,2.41,1.18,123014,34972,4997,646,35724,94443,71342,100086,51672,22928,"(CONTRACTS OF 125,000 EUROS)"
25/02/2003,EUR,1.0757,0.65%,0.0064,2.47,1.24,105427,29793,9730,969,26356,74269,57118,84968,48309,20459,"(CONTRACTS OF 125,000 EUROS)"
18/02/2003,EUR,1.0688,-0.42%,-0.0042,2.61,1.36,108102,31970,6485,259,24629,78293,56858,85037,51244,23065,"(CONTRACTS OF 125,000 EUROS)"
11/02/2003,EUR,1.0733,-1.34%,-0.0135,2.65,1.39,107453,29992,7694,618,23476,77469,54086,85781,53367,21672,"(CONTRACTS OF 125,000 EUROS)"
04/02/2003,EUR,1.0879,0.55%,0.0054,2.74,1.5,108531,37222,6556,594,21625,82247,59441,89397,49090,19134,"(CONTRACTS OF 125,000 EUROS)"
28/01/2003,EUR,1.082,0.90%,0.009,2.78,1.54,105577,32375,6039,1034,23265,78061,56674,85134,48903,20443,"(CONTRACTS OF 125,000 EUROS)"
21/01/2003,EUR,1.0723,1.64%,0.0163,2.75,1.51,113184,35332,6890,632,24410,83678,60374,91200,52810,21984,"(CONTRACTS OF 125,000 EUROS)"
14/01/2003,EUR,1.055,1.31%,0.013,2.75,1.47,110075,36455,7682,10,24937,83917,61402,91609,48673,18466,"(CONTRACTS OF 125,000 EUROS)"
07/01/2003,EUR,1.0414,-0.78%,-0.0078,2.77,1.48,98275,35647,7490,41,14990,71660,50678,79191,47597,19084,"(CONTRACTS OF 125,000 EUROS)"
31/12/2002,EUR,1.0496,1.92%,0.019,2.79,1.51,98699,35953,6943,541,14561,72690,51055,80174,47644,18525,"(CONTRACTS OF 125,000 EUROS)"
23/12/2002,EUR,1.0298,0.13%,0.0013,2.82,1.52,98907,36015,7888,41,14866,74408,50922,82337,47985,16570,"(CONTRACTS OF 125,000 EUROS)"
17/12/2002,EUR,1.0285,2.00%,0.0198,2.87,1.53,100434,37237,6636,884,15367,75985,53488,83505,46946,16929,"(CONTRACTS OF 125,000 EUROS)"
10/12/2002,EUR,1.0083,1.21%,0.0121,2.83,1.49,121589,33001,4937,1426,36663,94378,71090,100741,50499,20848,"(CONTRACTS OF 125,000 EUROS)"
03/12/2002,EUR,0.9962,0.28%,0.0028,2.89,1.54,98385,26199,3323,34,27160,77604,53393,80961,44992,17424,"(CONTRACTS OF 125,000 EUROS)"
26/11/2002,EUR,0.9934,-0.96%,-0.0096,2.98,1.63,99487,33446,4670,34,24416,79647,57896,84351,41591,15136,"(CONTRACTS OF 125,000 EUROS)"
19/11/2002,EUR,1.003,-0.90%,-0.009,3.01,1.67,103629,35945,5740,34,20823,81064,56802,86838,46827,16791,"(CONTRACTS OF 125,000 EUROS)"
12/11/2002,EUR,1.0121,1.25%,0.0124,3.07,1.73,105714,39308,6031,859,20436,83324,60603,90214,45111,15500,"(CONTRACTS OF 125,000 EUROS)"
05/11/2002,EUR,0.9996,1.67%,0.0165,3.12,1.6,102158,35721,4684,846,20272,82865,56839,88395,45319,13763,"(CONTRACTS OF 125,000 EUROS)"
29/10/2002,EUR,0.9832,0.56%,0.0056,3.18,1.51,83640,22948,3623,4,23470,67459,46422,71086,37218,12554,"(CONTRACTS OF 125,000 EUROS)"
22/10/2002,EUR,0.9777,-0.40%,-0.004,3.15,1.42,84417,19094,5026,1192,27771,63866,48057,70084,36360,14333,"(CONTRACTS OF 125,000 EUROS)"
15/10/2002,EUR,0.9816,0.33%,0.0033,3.19,1.49,88339,23224,2192,6,27830,72255,51060,74453,37279,13886,"(CONTRACTS OF 125,000 EUROS)"
08/10/2002,EUR,0.9784,-0.43%,-0.0043,3.13,1.48,84730,16724,4072,942,30603,65335,48269,70349,36461,14381,"(CONTRACTS OF 125,000 EUROS)"
01/10/2002,EUR,0.9826,0.10%,0.001,3.16,1.48,85802,20041,3104,6,28511,69993,48558,73103,37244,12699,"(CONTRACTS OF 125,000 EUROS)"
24/09/2002,EUR,0.9816,0.75%,0.0075,3.22,1.51,82896,17964,3362,434,28955,66600,47353,70396,35543,12500,"(CONTRACTS OF 125,000 EUROS)"
17/09/2002,EUR,0.9743,-0.07%,-0.0007,3.23,1.5,80614,16959,4349,683,25467,61514,43109,66546,37505,14068,"(CONTRACTS OF 125,000 EUROS)"
10/09/2002,EUR,0.975,-2.23%,-0.0225,3.21,1.48,115622,22711,2360,6,45761,91340,68478,93706,47144,21916,"(CONTRACTS OF 125,000 EUROS)"
03/09/2002,EUR,0.9972,1.49%,0.0147,3.25,1.52,109350,27290,2052,225,39510,88269,67025,90546,42325,18804,"(CONTRACTS OF 125,000 EUROS)"
27/08/2002,EUR,0.9826,0.47%,0.0047,3.28,1.55,104194,25994,3906,93,39784,85314,65871,89313,38323,14881,"(CONTRACTS OF 125,000 EUROS)"
20/08/2002,EUR,0.978,-0.60%,-0.006,3.27,1.58,100332,22528,4665,68,42936,80970,65532,85703,34800,14629,"(CONTRACTS OF 125,000 EUROS)"
13/08/2002,EUR,0.9839,1.87%,0.0186,3.26,1.63,97747,23123,3341,45,39504,80776,62672,84162,35075,13585,"(CONTRACTS OF 125,000 EUROS)"
06/08/2002,EUR,0.9658,-1.65%,-0.0166,3.27,1.56,104950,25104,5082,63,43557,83159,68724,88304,36226,16646,"(CONTRACTS OF 125,000 EUROS)"
30/07/2002,EUR,0.982,-0.77%,-0.0077,3.3,1.56,109782,29177,3694,59,41792,93114,71028,96867,38754,12915,"(CONTRACTS OF 125,000 EUROS)"
23/07/2002,EUR,0.9896,-2.17%,-0.0219,3.32,1.61,111955,30292,4614,0,34687,91754,64979,96368,46976,15587,"(CONTRACTS OF 125,000 EUROS)"
16/07/2002,EUR,1.0115,1.90%,0.0189,3.33,1.56,115406,35420,8766,59,34708,91153,70187,99978,45219,15428,"(CONTRACTS OF 125,000 EUROS)"
09/07/2002,EUR,0.9926,0.67%,0.0067,3.4,1.64,112614,33941,9859,27,30573,89224,64541,99110,48073,13504,"(CONTRACTS OF 125,000 EUROS)"
02/07/2002,EUR,0.986,0.66%,0.0066,3.35,1.58,114480,33583,9188,34,31863,91200,65480,100422,49000,14058,"(CONTRACTS OF 125,000 EUROS)"
25/06/2002,EUR,0.9795,2.89%,0.0285,3.37,1.59,116946,35304,12780,65,35405,88759,70774,101604,46172,15342,"(CONTRACTS OF 125,000 EUROS)"
18/06/2002,EUR,0.952,0.42%,0.0042,3.31,1.53,109609,39095,9638,1204,24857,86773,65156,97615,44453,11994,"(CONTRACTS OF 125,000 EUROS)"
11/06/2002,EUR,0.948,0.94%,0.0093,3.38,1.6,146872,39085,10718,751,57890,115423,97726,126892,49146,19980,"(CONTRACTS OF 125,000 EUROS)"
04/06/2002,EUR,0.9392,1.24%,0.0123,3.39,1.6,146821,40092,8476,1704,51768,121423,93564,131603,53257,15218,"(CONTRACTS OF 125,000 EUROS)"
28/05/2002,EUR,0.9277,0.84%,0.0083,3.41,1.61,143233,42415,10690,1522,45862,117164,89799,129376,53434,13857,"(CONTRACTS OF 125,000 EUROS)"
21/05/2002,EUR,0.92,1.95%,0.0193,3.39,1.59,136129,40857,9684,1521,42232,111910,84610,123115,51519,13014,"(CONTRACTS OF 125,000 EUROS)"
14/05/2002,EUR,0.9024,-1.37%,-0.0138,3.41,1.6,132612,42844,8244,1390,37941,110842,82175,120476,50437,12136,"(CONTRACTS OF 125,000 EUROS)"
07/05/2002,EUR,0.9149,1.66%,0.0164,3.32,1.56,135303,43808,8375,1096,39956,115033,84860,124504,50443,10799,"(CONTRACTS OF 125,000 EUROS)"
30/04/2002,EUR,0.9,1.29%,0.0129,3.3,1.49,124468,41770,10298,1564,34318,103942,77652,115804,46816,8664,"(CONTRACTS OF 125,000 EUROS)"
23/04/2002,EUR,0.8885,0.69%,0.0069,3.3,1.47,114239,39180,9557,1368,28512,91562,69060,102487,45179,11752,"(CONTRACTS OF 125,000 EUROS)"
16/04/2002,EUR,0.8824,0.17%,0.0017,3.32,1.46,115039,37941,10314,513,36153,92518,74607,103345,40432,11694,"(CONTRACTS OF 125,000 EUROS)"
09/04/2002,EUR,0.8809,0.22%,0.0022,3.34,1.47,105254,29472,10031,737,35521,83273,65730,94041,39524,11213,"(CONTRACTS OF 125,000 EUROS)"
02/04/2002,EUR,0.879,0.26%,0.0026,3.36,1.44,109996,34364,8206,25,35699,91003,70088,99234,39908,10762,"(CONTRACTS OF 125,000 EUROS)"
26/03/2002,EUR,0.8767,-0.65%,-0.0065,3.37,1.43,105052,30732,7439,22,33184,84427,63938,91888,41114,13164,"(CONTRACTS OF 125,000 EUROS)"
19/03/2002,EUR,0.8824,0.79%,0.0079,3.32,1.38,96111,28092,6836,22,29671,75935,57785,82793,38326,13318,"(CONTRACTS OF 125,000 EUROS)"
12/03/2002,EUR,0.8755,0.36%,0.0035,3.29,1.39,114001,24796,9335,569,44016,84487,69381,94391,44620,19610,"(CONTRACTS OF 125,000 EUROS)"
05/03/2002,EUR,0.8724,1.04%,0.0104,3.28,1.46,118935,20406,14118,191,56093,83303,76690,97612,42245,21323,"(CONTRACTS OF 125,000 EUROS)"
26/02/2002,EUR,0.8634,-1.48%,-0.0149,3.28,1.47,109561,20441,17308,171,47552,69941,68164,87420,41397,22141,"(CONTRACTS OF 125,000 EUROS)"
19/02/2002,EUR,0.8764,0.01%,0.0001,3.27,1.46,112662,22094,13447,91,50420,77338,72605,90876,40057,21786,"(CONTRACTS OF 125,000 EUROS)"
12/02/2002,EUR,0.8763,1.01%,0.0101,3.27,1.47,107689,16274,13020,62,51004,72450,67340,85532,40349,22157,"(CONTRACTS OF 125,000 EUROS)"
05/02/2002,EUR,0.8675,0.28%,0.0028,3.27,1.46,107814,16358,14035,132,52585,69303,69075,83470,38739,24344,"(CONTRACTS OF 125,000 EUROS)"
29/01/2002,EUR,0.8651,-2.35%,-0.0238,3.29,1.52,107634,15039,14184,101,52586,69151,67726,83436,39908,24198,"(CONTRACTS OF 125,000 EUROS)"
22/01/2002,EUR,0.8859,0.31%,0.0031,3.26,1.54,103166,22270,4981,93,40205,79729,62568,84803,40598,18363,"(CONTRACTS OF 125,000 EUROS)"
15/01/2002,EUR,0.8832,-1.09%,-0.0109,3.25,1.62,99564,19669,7573,47,38839,74716,58555,82336,41009,17228,"(CONTRACTS OF 125,000 EUROS)"
08/01/2002,EUR,0.8929,1.08%,0.0107,3.22,1.47,95885,20385,5612,807,33174,76510,54366,82929,41519,12956,"(CONTRACTS OF 125,000 EUROS)"
28/12/2001,EUR,0.8834,0.67%,0.0067,3.24,1.44,88738,19106,7924,0,32250,58140,51356,66064,37382,22674,"(CONTRACTS OF 125,000 EUROS)"
21/12/2001,EUR,0.8775,-2.81%,-0.0285,3.26,1.44,93493,23412,11990,581,27827,63775,51820,76346,41673,17147,"(CONTRACTS OF 125,000 EUROS)"
18/12/2001,EUR,0.9029,1.15%,0.0115,3.26,1.4,90033,21445,9574,897,25047,67263,47389,77734,42644,12299,"(CONTRACTS OF 125,000 EUROS)"
11/12/2001,EUR,0.8926,0.31%,0.0031,3.27,1.48,114593,19857,7951,40,48959,75401,68856,83392,45737,31201,"(CONTRACTS OF 125,000 EUROS)"
04/12/2001,EUR,0.8898,0.75%,0.0074,3.26,1.45,109051,22650,8804,39,46524,77654,69213,86497,39838,22554,"(CONTRACTS OF 125,000 EUROS)"
27/11/2001,EUR,0.8832,0.06%,0.0006,3.3,1.29,112644,17930,17015,719,55705,66262,74354,83996,38290,28648,"(CONTRACTS OF 125,000 EUROS)"
20/11/2001,EUR,0.8827,0.23%,0.0023,3.3,1.26,114006,17899,18185,114,56818,70035,74831,88334,39175,25672,"(CONTRACTS OF 125,000 EUROS)"
13/11/2001,EUR,0.8807,-1.58%,-0.0159,3.27,1.37,108807,15570,15086,5,48628,70765,64203,85856,44604,22951,"(CONTRACTS OF 125,000 EUROS)"
06/11/2001,EUR,0.8948,-1.06%,-0.0107,3.37,1.43,102865,21939,6587,30,40871,79450,62840,86067,40025,16798,"(CONTRACTS OF 125,000 EUROS)"
30/10/2001,EUR,0.9044,1.62%,0.0161,3.5,1.44,107845,24443,7757,493,40514,85308,65450,93558,42395,14287,"(CONTRACTS OF 125,000 EUROS)"
23/10/2001,EUR,0.89,-1.98%,-0.02,3.53,1.25,104525,17751,8361,216,45354,76666,63321,85243,41204,19282,"(CONTRACTS OF 125,000 EUROS)"
16/10/2001,EUR,0.908,-0.55%,-0.0055,3.58,1.24,106649,22095,4479,0,40634,89824,62729,94303,43920,12346,"(CONTRACTS OF 125,000 EUROS)"
09/10/2001,EUR,0.913,-0.63%,-0.0063,3.58,1.24,113099,27660,5219,531,36396,96883,64587,102633,48512,10466,"(CONTRACTS OF 125,000 EUROS)"
02/10/2001,EUR,0.9188,-0.46%,-0.0046,3.55,1.11,109676,28463,3511,324,35483,96388,64270,100223,45406,9453,"(CONTRACTS OF 125,000 EUROS)"
25/09/2001,EUR,0.923,-0.46%,-0.0046,3.59,1.17,108418,30766,2918,11,33101,95574,63878,98503,44540,9915,"(CONTRACTS OF 125,000 EUROS)"
18/09/2001,EUR,0.9273,1.46%,0.0144,3.71,0.89,100031,27680,3243,273,28800,87292,56753,90808,43278,9223,"(CONTRACTS OF 125,000 EUROS)"
10/09/2001,EUR,0.914,2.88%,0.0284,4.08,0.83,117970,21845,3996,242,43737,86898,65824,91136,52146,26834,"(CONTRACTS OF 125,000 EUROS)"
04/09/2001,EUR,0.8884,-2.63%,-0.0267,4.22,0.8,108326,25446,3625,283,35686,84764,61415,88672,46911,19654,"(CONTRACTS OF 125,000 EUROS)"
28/08/2001,EUR,0.9124,-0.56%,-0.0056,4.21,0.85,113131,31666,2161,157,33194,93070,65017,95388,48114,17743,"(CONTRACTS OF 125,000 EUROS)"
21/08/2001,EUR,0.9175,1.62%,0.016,4.24,0.81,109131,30729,1759,169,46443,103589,77341,105517,31790,3614,"(CONTRACTS OF 125,000 EUROS)"
14/08/2001,EUR,0.9029,2.92%,0.0288,4.3,0.87,99325,27479,3126,606,39997,91634,68082,95366,31243,3959,"(CONTRACTS OF 125,000 EUROS)"
07/08/2001,EUR,0.8773,0.14%,0.0014,4.37,0.8,94227,22076,5436,1164,28745,70251,51985,76851,42242,17376,"(CONTRACTS OF 125,000 EUROS)"
31/07/2001,EUR,0.8761,0.30%,0.003,4.39,0.78,89655,21210,5127,498,26097,65480,47805,71105,41850,18550,"(CONTRACTS OF 125,000 EUROS)"
24/07/2001,EUR,0.8735,1.61%,0.0159,4.42,0.8,87072,20062,5771,727,24519,61640,45308,68138,41764,18934,"(CONTRACTS OF 125,000 EUROS)"
17/07/2001,EUR,0.8597,0.60%,0.0059,4.43,0.8,84435,17084,8041,1363,28123,52300,46570,61704,37865,22731,"(CONTRACTS OF 125,000 EUROS)"
10/07/2001,EUR,0.8546,0.74%,0.0074,4.42,0.73,83100,17180,10529,765,28465,45139,46410,56433,36690,26667,"(CONTRACTS OF 125,000 EUROS)"
03/07/2001,EUR,0.8483,-1.76%,-0.0178,4.34,0.52,77138,14741,11495,1100,26321,37968,42162,50563,34976,26575,"(CONTRACTS OF 125,000 EUROS)"
26/06/2001,EUR,0.8635,1.15%,0.0114,4.34,0.68,75413,13806,10631,926,25888,40558,40620,52115,34793,23298,"(CONTRACTS OF 125,000 EUROS)"
19/06/2001,EUR,0.8537,0.08%,0.0008,4.4,0.76,73278,12297,8664,1482,25596,37560,39375,47706,33903,25572,"(CONTRACTS OF 125,000 EUROS)"
12/06/2001,EUR,0.853,-0.11%,-0.0011,4.42,0.61,114364,16502,21090,1364,54352,55921,72218,78375,42146,35989,"(CONTRACTS OF 125,000 EUROS)"
05/06/2001,EUR,0.8539,-0.18%,-0.0018,4.39,0.58,99312,15748,20561,1800,43561,55503,61109,77864,38203,21448,"(CONTRACTS OF 125,000 EUROS)"
29/05/2001,EUR,0.8554,-1.09%,-0.0109,4.49,0.59,93121,15862,18793,319,37947,55984,54128,75096,38993,18025,"(CONTRACTS OF 125,000 EUROS)"
22/05/2001,EUR,0.8648,-1.50%,-0.0151,4.54,0.63,92969,13720,19173,324,40057,54258,54101,73755,38868,19214,"(CONTRACTS OF 125,000 EUROS)"
15/05/2001,EUR,0.878,-0.80%,-0.0081,4.52,0.58,88743,13881,10473,430,37044,62243,51355,73146,37388,15597,"(CONTRACTS OF 125,000 EUROS)"
08/05/2001,EUR,0.8851,-0.86%,-0.0087,4.7,0.76,87560,12030,7676,91,36381,67658,48502,75425,39058,12135,"(CONTRACTS OF 125,000 EUROS)"
01/05/2001,EUR,0.8928,-0.13%,-0.0013,4.79,0.61,82811,12005,5961,448,32807,69241,45260,75650,37551,7161,"(CONTRACTS OF 125,000 EUROS)"
24/04/2001,EUR,0.894,1.18%,0.0117,4.75,0.51,80964,12647,5344,104,31366,68983,44117,74431,36847,6533,"(CONTRACTS OF 125,000 EUROS)"
17/04/2001,EUR,0.8836,-0.54%,-0.0054,4.72,0.06,77532,12851,7858,309,28686,58926,41846,67093,35686,10439,"(CONTRACTS OF 125,000 EUROS)"
10/04/2001,EUR,0.8884,-1.06%,-0.0106,4.54,-0.14,75092,11040,5295,81,29219,51528,40340,56904,34752,18188,"(CONTRACTS OF 125,000 EUROS)"
03/04/2001,EUR,0.8979,0.55%,0.0055,4.52,-0.26,77853,12823,6048,426,30257,53667,43506,60141,34347,17712,"(CONTRACTS OF 125,000 EUROS)"
27/03/2001,EUR,0.893,-1.78%,-0.018,4.52,-0.28,73047,9243,5359,78,28945,49225,38266,54662,34781,18385,"(CONTRACTS OF 125,000 EUROS)"
20/03/2001,EUR,0.9092,-0.57%,-0.0057,4.68,-0.1,73043,8415,5802,25,28968,53720,37408,59547,35635,13496,"(CONTRACTS OF 125,000 EUROS)"
13/03/2001,EUR,0.9144,-2.11%,-0.0213,4.72,-0.15,102063,9179,1352,845,46386,81465,56410,83662,45653,18401,"(CONTRACTS OF 125,000 EUROS)"
06/03/2001,EUR,0.9341,1.82%,0.018,4.72,-0.3,96223,17250,186,639,35850,80960,53739,81785,42484,14438,"(CONTRACTS OF 125,000 EUROS)"
27/02/2001,EUR,0.9174,0.58%,0.0058,4.71,-0.24,94625,12364,2851,0,40411,76447,52775,79298,41850,15327,"(CONTRACTS OF 125,000 EUROS)"
20/02/2001,EUR,0.9121,-0.92%,-0.0093,4.73,-0.57,89783,10940,938,66,35298,72179,46304,73183,43479,16600,"(CONTRACTS OF 125,000 EUROS)"
13/02/2001,EUR,0.9206,-1.09%,-0.0109,4.68,-0.63,90316,16118,1416,61,32266,74715,48445,76192,41871,14124,"(CONTRACTS OF 125,000 EUROS)"
06/02/2001,EUR,0.9307,0.45%,0.0045,4.67,-0.68,90774,16903,2568,63,29456,74894,46422,77525,44352,13249,"(CONTRACTS OF 125,000 EUROS)"
30/01/2001,EUR,0.9265,-1.18%,-0.0119,4.73,-0.69,85158,16910,750,63,26214,71507,43187,72320,41971,12838,"(CONTRACTS OF 125,000 EUROS)"
23/01/2001,EUR,0.9376,-0.40%,-0.004,4.69,-0.82,85880,18885,1643,3,26742,71235,45630,72881,40250,12999,"(CONTRACTS OF 125,000 EUROS)"
16/01/2001,EUR,0.9414,-0.40%,-0.004,4.76,-0.93,93621,24015,3280,145,25094,77345,49254,80770,44367,12851,"(CONTRACTS OF 125,000 EUROS)"
09/01/2001,EUR,0.9452,-0.46%,-0.0046,4.63,-0.88,92722,25570,1738,229,23388,76659,49187,78626,43535,14096,"(CONTRACTS OF 125,000 EUROS)"
02/01/2001,EUR,0.9496,2.02%,0.02,4.76,-1.41,84654,28678,1604,6,16458,72543,45142,74153,39512,10501,"(CONTRACTS OF 125,000 EUROS)"
26/12/2000,EUR,0.9308,4.08%,0.04,4.78,-1.53,84237,28255,1875,27,15504,70687,43786,72589,40451,11648,"(CONTRACTS OF 125,000 EUROS)"
19/12/2000,EUR,0.8943,1.76%,0.0175,4.84,-1.57,77326,22289,475,38,15586,67727,37913,68240,39413,9086,"(CONTRACTS OF 125,000 EUROS)"
12/12/2000,EUR,0.8788,-0.09%,-0.0009,4.93,-1.54,98322,20411,879,154,37199,83304,57764,84337,40558,13985,"(CONTRACTS OF 125,000 EUROS)"
05/12/2000,EUR,0.8796,2.71%,0.0267,4.91,-1.63,89752,16995,967,35,35485,75350,52515,76352,37237,13400,"(CONTRACTS OF 125,000 EUROS)"
28/11/2000,EUR,0.8564,1.55%,0.0154,5.02,-1.66,85904,11221,4280,103,37403,64284,48727,68667,37177,17237,"(CONTRACTS OF 125,000 EUROS)"
21/11/2000,EUR,0.8433,-1.70%,-0.0172,4.75,-1.91,81781,11397,5489,103,35273,56874,46773,62466,35008,19315,"(CONTRACTS OF 125,000 EUROS)"
14/11/2000,EUR,0.8579,-0.27%,-0.0027,5.06,-1.59,78068,11197,8462,93,32903,52762,44193,61317,33875,16751,"(CONTRACTS OF 125,000 EUROS)"
07/11/2000,EUR,0.8602,1.32%,0.0131,5.02,-1.64,73922,11615,7837,96,28448,48798,40159,56731,33763,17191,"(CONTRACTS OF 125,000 EUROS)"
31/10/2000,EUR,0.849,1.60%,0.0159,5.04,-1.61,75650,11095,8922,94,29207,48019,40396,57035,35254,18615,"(CONTRACTS OF 125,000 EUROS)"
24/10/2000,EUR,0.8356,-2.15%,-0.0218,5,-1.64,76773,10198,8365,94,31077,49632,41369,58091,35404,18682,"(CONTRACTS OF 125,000 EUROS)"
17/10/2000,EUR,0.854,-2.01%,-0.0203,4.92,-1.69,73195,10224,8504,44,29498,47644,39766,56192,33429,17003,"(CONTRACTS OF 125,000 EUROS)"
10/10/2000,EUR,0.8715,-0.42%,-0.0042,4.97,-1.69,71703,10749,5346,61,25878,49257,36688,54664,35015,17039,"(CONTRACTS OF 125,000 EUROS)"
03/10/2000,EUR,0.8752,-0.84%,-0.0084,4.95,-1.76,67596,8336,4943,61,26050,45677,34447,50681,33149,16915,"(CONTRACTS OF 125,000 EUROS)"
26/09/2000,EUR,0.8826,3.71%,0.0365,4.85,-1.7,66421,6334,6185,61,26471,41681,32866,47927,33555,18494,"(CONTRACTS OF 125,000 EUROS)"
19/09/2000,EUR,0.851,-1.45%,-0.0146,4.73,-1.85,73646,10333,14570,51,28109,41289,38493,55910,35153,17736,"(CONTRACTS OF 125,000 EUROS)"
12/09/2000,EUR,0.8635,-2.93%,-0.0298,4.81,-1.79,84086,9717,8543,35,33165,53837,42917,62415,41169,21671,"(CONTRACTS OF 125,000 EUROS)"
05/09/2000,EUR,0.8896,-0.29%,-0.0029,4.73,-1.86,77486,13034,12652,37,27815,44012,40886,56701,36600,20785,"(CONTRACTS OF 125,000 EUROS)"
29/08/2000,EUR,0.8922,-0.52%,-0.0053,4.87,-1.71,73012,13536,12330,39,25725,40097,39300,52466,33712,20546,"(CONTRACTS OF 125,000 EUROS)"
22/08/2000,EUR,0.8969,-1.71%,-0.0172,4.83,-1.77,70673,12579,9219,38,25708,42839,38325,52096,32348,18577,"(CONTRACTS OF 125,000 EUROS)"
15/08/2000,EUR,0.9125,1.18%,0.0117,4.76,-1.8,68247,13730,6096,38,23052,42554,36820,48688,31427,19559,"(CONTRACTS OF 125,000 EUROS)"
08/08/2000,EUR,0.9019,-1.31%,-0.0132,4.57,-2,68746,14476,6114,18,23153,41248,37647,47380,31099,21366,"(CONTRACTS OF 125,000 EUROS)"
01/08/2000,EUR,0.9139,-2.59%,-0.0262,4.56,-2.07,62111,14538,4266,21,16807,40834,31366,45121,30745,16990,"(CONTRACTS OF 125,000 EUROS)"
25/07/2000,EUR,0.9382,1.54%,0.0153,4.53,-2.1,62286,15474,3077,202,16172,45269,31848,48548,30438,13738,"(CONTRACTS OF 125,000 EUROS)"
18/07/2000,EUR,0.924,-2.96%,-0.0301,4.53,-2.12,58300,13011,4966,18,14944,37940,27973,42924,30327,15376,"(CONTRACTS OF 125,000 EUROS)"
11/07/2000,EUR,0.9522,0.16%,0.0016,4.51,-2.12,55213,12726,2596,18,13802,42884,26546,45498,28667,9715,"(CONTRACTS OF 125,000 EUROS)"
05/07/2000,EUR,0.9507,0.53%,0.0053,4.51,-2.14,54598,11222,3772,18,13665,41742,24905,45532,29693,9066,"(CONTRACTS OF 125,000 EUROS)"
27/06/2000,EUR,0.9457,-0.90%,-0.0091,4.46,-2.21,52074,10869,1808,18,13312,39353,24199,41179,27875,10895,"(CONTRACTS OF 125,000 EUROS)"
20/06/2000,EUR,0.9543,-0.49%,-0.0049,4.39,-2.29,54310,11433,1808,18,13540,41966,24991,43792,29319,10518,"(CONTRACTS OF 125,000 EUROS)"
13/06/2000,EUR,0.959,0.49%,0.0049,4.45,-2.3,68349,12533,2201,44,23551,52974,36128,55219,32221,13130,"(CONTRACTS OF 125,000 EUROS)"
06/06/2000,EUR,0.9543,2.63%,0.026,4.35,-2.35,66367,13892,3941,47,19955,49428,33894,53416,32473,12951,"(CONTRACTS OF 125,000 EUROS)"
30/05/2000,EUR,0.9298,2.47%,0.0244,4.37,-2.45,65497,13958,7449,148,21118,43292,35224,50889,30273,14608,"(CONTRACTS OF 125,000 EUROS)"
23/05/2000,EUR,0.9074,0.80%,0.008,4.43,-2.34,68152,13759,13240,3,23725,37782,37487,51025,30665,17127,"(CONTRACTS OF 125,000 EUROS)"
16/05/2000,EUR,0.9002,-0.78%,-0.0079,4.23,-2.73,65049,14638,14102,18,21877,34591,36533,48711,28516,16338,"(CONTRACTS OF 125,000 EUROS)"
09/05/2000,EUR,0.9073,-0.27%,-0.0028,4.2,-2.45,68044,17710,19889,18,23626,35464,41354,55371,26690,12673,"(CONTRACTS OF 125,000 EUROS)"
02/05/2000,EUR,0.9098,-1.19%,-0.012,4.14,-2.38,69848,20881,19232,11,21779,33062,42671,52305,27177,17543,"(CONTRACTS OF 125,000 EUROS)"
25/04/2000,EUR,0.9208,-2.63%,-0.0267,3.92,-2.3,64805,18169,17189,44,21954,32608,40167,49841,24638,14964,"(CONTRACTS OF 125,000 EUROS)"
18/04/2000,EUR,0.9457,-1.38%,-0.0139,3.87,-2.3,60605,15619,17283,4,21364,28589,36987,45876,23618,14729,"(CONTRACTS OF 125,000 EUROS)"
11/04/2000,EUR,0.9589,-0.14%,-0.0014,3.86,-2.36,56936,13961,18817,4,20918,26160,34883,44981,22053,11955,"(CONTRACTS OF 125,000 EUROS)"
04/04/2000,EUR,0.9602,-0.01%,-0.0001,3.78,-2.44,55207,11796,20320,4,20838,22406,32638,42730,22569,12477,"(CONTRACTS OF 125,000 EUROS)"
28/03/2000,EUR,0.9603,-0.37%,-0.0037,3.72,-2.47,52329,10471,22111,3,22090,16898,32564,39012,19765,13317,"(CONTRACTS OF 125,000 EUROS)"
21/03/2000,EUR,0.9639,-0.42%,-0.0042,3.69,-2.47,51262,10790,22815,3,21046,15655,31839,38473,19423,12789,"(CONTRACTS OF 125,000 EUROS)"
14/03/2000,EUR,0.968,0.88%,0.0087,3.76,-2.37,50962,10269,23908,116,22299,14019,32684,38043,18278,12919,"(CONTRACTS OF 125,000 EUROS)"
07/03/2000,EUR,0.9596,-0.52%,-0.0052,3.62,-2.43,74944,9425,27378,560,43855,32320,53840,60258,21104,14686,"(CONTRACTS OF 125,000 EUROS)"
29/02/2000,EUR,0.9646,-3.91%,-0.0398,3.58,-2.47,64192,9518,17109,296,34993,32990,44807,50395,19385,13797,"(CONTRACTS OF 125,000 EUROS)"
22/02/2000,EUR,1.0038,2.30%,0.0228,3.56,-2.44,68723,17116,14472,33,28016,41556,45165,56061,23558,12662,"(CONTRACTS OF 125,000 EUROS)"
15/02/2000,EUR,0.9812,-0.43%,-0.0043,3.44,-2.52,66045,12223,17637,249,32406,33963,44878,51849,21167,14196,"(CONTRACTS OF 125,000 EUROS)"
08/02/2000,EUR,0.9854,1.37%,0.0136,3.38,-2.67,69619,11144,27836,173,37681,28322,48998,56331,20621,13288,"(CONTRACTS OF 125,000 EUROS)"
01/02/2000,EUR,0.9721,-2.82%,-0.0286,3.41,-2.64,74547,11318,34328,5,41307,25769,52630,60102,21917,14445,"(CONTRACTS OF 125,000 EUROS)"
25/01/2000,EUR,1.0003,-1.23%,-0.0124,3.23,-2.73,65619,11274,24577,5,33231,27568,44510,52150,21109,13469,"(CONTRACTS OF 125,000 EUROS)"
18/01/2000,EUR,1.0128,-1.97%,-0.0199,3.28,-2.71,62211,11255,19273,5,31959,31022,43219,50300,18992,11911,"(CONTRACTS OF 125,000 EUROS)"
11/01/2000,EUR,1.0332,0.23%,0.0023,3.25,-2.63,64026,21041,12327,479,21641,41580,43161,54386,20865,9640,"(CONTRACTS OF 125,000 EUROS)"
04/01/2000,EUR,1.0308,2.37%,0.0235,3.25,-2.8,52778,10966,16155,111,22014,26204,33091,42470,19687,10308,"(CONTRACTS OF 125,000 EUROS)"
28/12/1999,EUR,1.0069,-0.25%,-0.0025,3.17,-2.83,54115,9737,25151,22,28364,16983,38123,42156,15992,11959,"(CONTRACTS OF 125,000 EUROS)"
21/12/1999,EUR,1.0094,0.37%,0.0037,3.23,-2.97,46637,9708,18619,337,21022,17054,31067,36010,15570,10627,"(CONTRACTS OF 125,000 EUROS)"
14/12/1999,EUR,1.0057,-1.90%,-0.0192,3.42,-2.68,55677,7414,24270,63,29190,14049,36667,38382,19010,17295,"(CONTRACTS OF 125,000 EUROS)"
07/12/1999,EUR,1.0252,1.62%,0.016,3.28,-2.8,79429,6244,26982,312,53411,36291,59967,63585,19462,15844,"(CONTRACTS OF 125,000 EUROS)"
30/11/1999,EUR,1.0089,-1.87%,-0.0189,3.37,-2.66,70945,9203,34254,69,42076,20853,51348,55176,19597,15769,"(CONTRACTS OF 125,000 EUROS)"
23/11/1999,EUR,1.0281,-0.14%,-0.0014,3.38,-2.62,65696,9084,23429,0,39998,29333,49082,52762,16614,12934,"(CONTRACTS OF 125,000 EUROS)"
16/11/1999,EUR,1.0295,-1.04%,-0.0104,3.34,-2.68,59141,8225,17234,0,34126,26828,42351,44062,16790,15079,"(CONTRACTS OF 125,000 EUROS)"
09/11/1999,EUR,1.0403,-1.09%,-0.011,3.37,-2.59,54274,7794,12684,123,28776,27636,36693,40443,17581,13831,"(CONTRACTS OF 125,000 EUROS)"
02/11/1999,EUR,1.0518,-0.71%,-0.0071,3.43,-2.67,52693,9572,14165,0,24640,27832,34212,41997,18481,10696,"(CONTRACTS OF 125,000 EUROS)"
26/10/1999,EUR,1.0593,-2.13%,-0.0216,3.42,-2.75,55336,18338,8099,0,17950,36989,36288,45088,19048,10248,"(CONTRACTS OF 125,000 EUROS)"
19/10/1999,EUR,1.0824,0.50%,0.005,3.13,-2.99,67889,30433,7048,197,14614,54214,45244,61459,22645,6430,"(CONTRACTS OF 125,000 EUROS)"
12/10/1999,EUR,1.077,0.32%,0.0032,3.07,-3.06,55196,19344,6245,0,15945,40629,35289,46874,19907,8322,"(CONTRACTS OF 125,000 EUROS)"
05/10/1999,EUR,1.0736,2.03%,0.0201,3.21,-2.87,52695,18324,5345,22,15887,39841,34233,45208,18462,7487,"(CONTRACTS OF 125,000 EUROS)"
28/09/1999,EUR,1.0522,0.30%,0.003,2.67,-2.68,42520,11836,9603,143,15282,20809,27261,30555,15259,11965,"(CONTRACTS OF 125,000 EUROS)"
21/09/1999,EUR,1.0491,1.31%,0.013,2.66,-2.79,40795,7377,8937,99,17725,18847,25201,27883,15594,12912,"(CONTRACTS OF 125,000 EUROS)"
14/09/1999,EUR,1.0355,-2.19%,-0.0222,2.67,-2.78,36189,6079,8642,14,16427,15051,22520,23707,13669,12482,"(CONTRACTS OF 125,000 EUROS)"
07/09/1999,EUR,1.0587,0.24%,0.0024,2.65,-2.77,54762,8580,6736,2,31937,39448,40519,46186,14243,8576,"(CONTRACTS OF 125,000 EUROS)"
31/08/1999,EUR,1.0562,0.18%,0.0018,2.66,-2.78,59260,12506,9044,1,32868,39998,45375,49043,13885,10217,"(CONTRACTS OF 125,000 EUROS)"
24/08/1999,EUR,1.0543,0.36%,0.0036,2.64,-2.81,54915,8883,8278,249,33071,36635,42203,45162,12712,9753,"(CONTRACTS OF 125,000 EUROS)"
17/08/1999,EUR,1.0505,-1.85%,-0.0187,2.63,-2.78,55724,8982,7739,77,31859,38774,40918,46590,14806,9134,"(CONTRACTS OF 125,000 EUROS)"
10/08/1999,EUR,1.0703,0.26%,0.0026,2.66,-2.76,58263,19391,7490,147,22527,44097,42065,51734,16198,6529,"(CONTRACTS OF 125,000 EUROS)"
03/08/1999,EUR,1.0675,0.42%,0.0042,2.67,-2.62,54806,14433,6980,387,25465,40227,40285,47594,14521,7212,"(CONTRACTS OF 125,000 EUROS)"
27/07/1999,EUR,1.063,2.12%,0.021,2.65,-2.63,51204,10749,8946,282,27311,34569,38342,43797,12862,7407,"(CONTRACTS OF 125,000 EUROS)"
20/07/1999,EUR,1.0409,2.45%,0.0242,2.67,-2.54,46600,8225,14232,263,21332,20852,29820,35347,16780,11253,"(CONTRACTS OF 125,000 EUROS)"
13/07/1999,EUR,1.016,-0.74%,-0.0075,2.63,-2.58,45494,8534,13846,166,20745,17688,29445,31700,16049,13794,"(CONTRACTS OF 125,000 EUROS)"
06/07/1999,EUR,1.0236,-0.83%,-0.0084,2.61,-2.6,45102,7199,12910,151,22378,16169,29728,29230,15374,15872,"(CONTRACTS OF 125,000 EUROS)"
29/06/1999,EUR,1.0322,-0.01%,-0.0001,2.62,-2.57,39950,7465,11333,247,18318,17985,26030,29565,13920,10385,"(CONTRACTS OF 125,000 EUROS)"
22/06/1999,EUR,1.0323,-0.95%,-0.0095,2.6,-2.53,39349,6740,12062,347,18990,14846,26077,27255,13272,12094,"(CONTRACTS OF 125,000 EUROS)"
15/06/1999,EUR,1.0422,-0.39%,-0.0039,2.53,-2.59,37512,4962,13485,48,18769,13033,23779,26566,13733,10946,"(CONTRACTS OF 125,000 EUROS)"
08/06/1999,EUR,1.0463,0.12%,0.0012,2.47,-2.56,61075,4508,13482,200,40055,31752,44763,45434,16312,15641,"(CONTRACTS OF 125,000 EUROS)"
01/06/1999,EUR,1.045,-1.55%,-0.0157,2.54,-2.44,57438,4676,12684,229,38915,31007,43820,43920,13618,13518,"(CONTRACTS OF 125,000 EUROS)"
25/05/1999,EUR,1.0615,-0.59%,-0.0059,2.53,-2.4,47949,1278,10790,344,34429,26540,36051,37674,11898,10275,"(CONTRACTS OF 125,000 EUROS)"
18/05/1999,EUR,1.0678,-0.26%,-0.0026,2.53,-2.41,45633,1445,12008,310,31512,24088,33267,36406,12366,9227,"(CONTRACTS OF 125,000 EUROS)"
11/05/1999,EUR,1.0706,0.70%,0.0069,2.53,-2.34,43471,1842,12542,344,30936,21332,33122,34218,10349,9253,"(CONTRACTS OF 125,000 EUROS)"
04/05/1999,EUR,1.0632,-0.28%,-0.0028,2.53,-2.34,41973,978,20158,320,30356,11129,31654,31607,10319,10366,"(CONTRACTS OF 125,000 EUROS)"
27/04/1999,EUR,1.0662,0.34%,0.0034,2.54,-2.32,42000,2098,20956,320,30351,11380,32769,32656,9231,9344,"(CONTRACTS OF 125,000 EUROS)"
20/04/1999,EUR,1.0626,-1.43%,-0.0144,2.51,-2.43,43656,702,25204,320,33493,9177,34515,34701,9141,8955,"(CONTRACTS OF 125,000 EUROS)"
13/04/1999,EUR,1.078,-0.49%,-0.0049,2.59,-2.35,31725,992,15152,56,19509,8632,20557,23840,11168,7885,"(CONTRACTS OF 125,000 EUROS)"
06/04/1999,EUR,1.0833,1.07%,0.0107,2.8,-2.07,30360,892,11934,285,18515,9225,19692,21444,10668,8916,"(CONTRACTS OF 125,000 EUROS)"
30/03/1999,EUR,1.0718,-1.76%,-0.0178,2.91,-2.03,36612,671,17948,0,26814,9094,27485,27042,9127,9570,"(CONTRACTS OF 125,000 EUROS)"
23/03/1999,EUR,1.091,-0.68%,-0.0069,2.94,-1.93,29252,1027,10156,115,20482,7711,21624,17982,7628,11270,"(CONTRACTS OF 125,000 EUROS)"
16/03/1999,EUR,1.0985,0.92%,0.0091,2.94,-1.95,32579,819,12823,0,20636,7607,21455,20430,11124,12149,"(CONTRACTS OF 125,000 EUROS)"
09/03/1999,EUR,1.0885,-0.43%,-0.0043,3.04,-1.84,44090,4730,13674,60,24203,9521,28993,23255,15097,20835,"(CONTRACTS OF 125,000 EUROS)"
02/03/1999,EUR,1.0932,-0.67%,-0.0067,3.07,-1.87,35989,2130,15704,0,20976,3364,23106,19068,12883,16921,"(CONTRACTS OF 125,000 EUROS)"
23/02/1999,EUR,1.1006,-1.73%,-0.0175,3,-1.87,37157,280,17425,0,24049,4669,24329,22094,12828,15063,"(CONTRACTS OF 125,000 EUROS)"
16/02/1999,EUR,1.12,-0.92%,-0.0092,3.05,-1.84,30110,450,15481,0,19118,4702,19568,20183,10542,9927,"(CONTRACTS OF 125,000 EUROS)"
09/02/1999,EUR,1.1304,-0.39%,-0.0039,3.06,-1.85,30301,438,13561,0,19827,6795,20265,20356,10036,9945,"(CONTRACTS OF 125,000 EUROS)"
02/02/1999,EUR,1.1348,-1.80%,-0.0182,2.97,-1.94,27050,1930,12284,0,14133,5741,16063,18025,10987,9025,"(CONTRACTS OF 125,000 EUROS)"
26/01/1999,EUR,1.1556,-0.43%,-0.0043,3,-1.84,6850,1256,270,0,2431,3519,3687,3789,3163,3061,"(CONTRACTS OF 125,000 EUROS)"
19/01/1999,EUR,1.1606,0.32%,0.0032,2.96,-1.87,6184,1256,283,0,1647,3480,2903,3763,3281,2421,"(CONTRACTS OF 125,000 EUROS)"
12/01/1999,EUR,1.1569,-1.63%,-0.0165,3.13,-1.81,8241,1717,1277,0,1849,2984,3566,4261,4675,3980,"(CONTRACTS OF 125,000 EUROS)"
05/01/1999,EUR,1.1761,0.43%,0.0043,3.13,-1.8,2091,0,240,0,0,1428,0,1668,2091,423,"(CONTRACTS OF 125,000 EUROS)"
